oldcode,total_pop_80,pop16_19_80,pop18_24_80,pop25plus_80,pop18plus_80,hsplus_25plus_80,somecollege_25plus_80,collegeplus_25plus_80,hsplus_18plus_80,somecollege_18plus_80,collegeplus_18plus_80,hsplus_18_24_80,somecollege_18_24_80,collegeplus_18_24_80,inschool_16_19_80,pctinschool_16_19_80,pcthsplus_18_24_80,pctsomecollege_18_24_80,pctcollegeplus_18_24_80,pcthsplus_25plus_80,pctsomecollege_25plus_80,pctcollegeplus_25plus_80,povrate60
1001,32259,2834,4007,17440,21447,10366,4221,2117,13105,5140,2251,2739,919,134,1942,.6852505,.6835538,.2293486,.0334415,.5943807,.2420298,.1213876,52.95928
1002,78556,5930,8872,45605,54477,27480,12100,5498,33125,13972,5888,5645,1872,390,4047,.682462,.6362714,.2110009,.0439585,.6025655,.2653218,.120557,41.67101
1003,24756,1936,2574,14092,16666,6333,2662,1300,7825,3139,1393,1492,477,93,1487,.7680785,.5796426,.1853147,.0361305,.4494039,.1889015,.0922509,65.64565
1004,15723,1214,1840,8834,10674,3580,969,433,4676,1198,496,1096,229,63,713,.5873147,.5956522,.1244565,.0342391,.4052524,.1096898,.0490152,56.27055
1005,36459,2610,3908,21640,25548,9974,2963,1144,12524,3536,1244,2550,573,100,1599,.6126437,.6525077,.1466223,.0255885,.4609057,.1369224,.0528651,45.62446
1006,10596,958,1129,5887,7016,2414,1090,516,3043,1323,528,629,233,12,744,.7766179,.5571302,.2063773,.0106289,.4100561,.1851537,.0876508,71.88475
1007,21680,1438,2192,12609,14801,5680,2045,1029,7224,2471,1124,1544,426,95,995,.6919332,.7043796,.1943431,.0433394,.4504719,.1621857,.0816084,63.27154
1008,119761,11444,20255,65341,85596,37073,15662,7213,51917,20876,8056,14844,5214,843,6286,.5492834,.7328561,.2574179,.0416194,.5673773,.2396964,.1103901,34.06308
1009,39191,2790,4225,23108,27333,10492,3948,1710,12728,4665,1841,2236,717,131,1870,.6702509,.5292308,.1697041,.0310059,.4540419,.1708499,.0740003,42.77838
1010,18760,1268,2123,11227,13350,4855,1697,712,6251,2024,723,1396,327,11,740,.5835962,.6575601,.1540273,.0051813,.4324397,.1511535,.0634185,47.20592
1011,30612,2168,3461,17932,21393,8254,2676,1158,10262,3018,1232,2008,342,74,1367,.6305351,.5801792,.0988154,.0213811,.4602945,.1492304,.0645773,52.22901
1012,16839,1262,1864,9207,11071,4112,1417,640,5172,1678,704,1060,261,64,826,.6545166,.5686696,.1400215,.0343348,.4466167,.1539046,.0695123,62.10922
1013,27702,2279,3091,15077,18168,7450,2854,1344,9403,3322,1455,1953,468,111,1678,.7362878,.6318343,.1514073,.0359107,.4941301,.1892949,.0891424,58.46618
1014,13703,988,1467,8053,9520,3752,1169,479,4611,1433,527,859,264,48,686,.694332,.5855488,.1799591,.0327198,.4659133,.1451633,.0594809,49.76548
1015,12595,910,1403,7425,8828,2847,816,431,3637,976,456,790,160,25,472,.5186813,.5630791,.1140413,.017819,.3834344,.109899,.0580471,52.19971
1016,38533,2910,4398,22676,27074,12840,6144,2766,15833,7303,3013,2993,1159,247,2257,.7756014,.6805366,.2635289,.0561619,.5662374,.2709472,.1219792,50.68407
1017,54519,4194,6540,32231,38771,18000,6790,3034,22365,8249,3331,4365,1459,297,2664,.6351931,.6674312,.2230887,.0454128,.5584686,.2106667,.094133,35.32662
1018,15884,1251,1852,9036,10888,3839,1270,556,4948,1535,596,1109,265,40,845,.6754596,.5988121,.1430885,.0215983,.4248561,.1405489,.0615317,62.96134
1019,11377,746,1255,6646,7901,2866,766,237,3610,988,274,744,222,37,519,.6957105,.5928287,.1768924,.0294821,.4312368,.1152573,.0356605,51.69877
1020,36850,2644,4029,22916,26945,10145,3744,1636,12645,4670,1792,2500,926,156,1816,.6868382,.6205013,.2298337,.0387193,.4427038,.1633793,.0713912,46.30926
1021,14110,1024,1456,8472,9928,3187,1125,576,3957,1352,592,770,227,16,661,.6455078,.5288461,.1559066,.010989,.3761804,.1327904,.0679887,64.90812
1022,61642,4475,6987,36781,43768,17146,5793,2671,21833,7157,2802,4687,1364,131,2807,.6272626,.6708173,.1952197,.0187491,.4661646,.1574998,.072619,48.08134
1023,47821,4013,8300,24890,33190,16154,7579,2898,22296,9353,3246,6142,1774,348,2251,.560927,.74,.2137349,.0419277,.6490157,.3044998,.1164323,40.67883
1024,53981,4573,6715,28837,35552,15430,6840,3265,20028,8528,3552,4598,1688,287,3154,.6897004,.6847357,.2513775,.0427401,.5350764,.2371953,.1132226,58.20935
1025,53658,3749,6115,31948,38063,13632,4696,1808,17439,5384,1925,3807,688,117,2175,.5801547,.6225675,.1125102,.0191333,.4266934,.1469889,.056592,49.62872
1026,43390,3152,5221,25043,30264,14458,5289,2567,17618,6212,2700,3160,923,133,2060,.6535533,.605248,.1767861,.025474,.577327,.2111967,.1025037,47.93242
1027,38440,3041,4514,22023,26537,11181,3951,1586,14216,4890,1700,3035,939,114,2066,.6793818,.6723527,.2080195,.0252548,.5076965,.1794033,.0720156,47.24581
1028,103057,6760,11700,61730,73430,33888,13544,5491,42097,16466,5938,8209,2922,447,4682,.6926035,.7016239,.2497436,.0382051,.5489714,.2194071,.0889519,35.82675
1029,18809,1310,2025,11238,13263,4898,1576,820,6233,1937,862,1335,361,42,951,.7259542,.6592593,.1782716,.0207407,.4358427,.1402385,.0729667,52.51355
1030,28350,1997,3182,17173,20355,7742,2680,1029,9847,3220,1112,2105,540,83,1387,.6945418,.6615337,.1697046,.0260842,.450824,.1560589,.0599196,49.874
1031,24253,1733,2630,14473,17103,6657,2157,861,8227,2616,894,1570,459,33,1109,.6399308,.5969582,.1745247,.0125475,.4599599,.1490361,.0594901,53.8095
1032,11021,961,1211,5805,7016,2317,1036,558,3047,1272,585,730,236,27,784,.8158169,.6028076,.1948803,.0222956,.3991387,.1784668,.096124,77.78582
1033,15604,1404,1855,8424,10279,3217,1210,564,4380,1511,599,1163,301,35,1005,.715812,.6269542,.1622642,.0188679,.3818851,.1436372,.0669516,70.75676
1034,15302,1094,1645,9013,10658,3962,1583,779,4916,1846,814,954,263,35,723,.6608775,.5799392,.1598784,.0212766,.4395873,.1756352,.0864307,64.05679
1035,74632,5455,8688,42780,51468,24936,10956,5435,30788,13082,5834,5852,2126,399,4032,.7391384,.6735727,.2447053,.0459254,.5828892,.256101,.1270453,46.03269
1036,51407,3564,5970,29555,35525,14132,5090,1996,17924,5919,2126,3792,829,130,1920,.5387205,.6351759,.138861,.0217755,.4781594,.1722213,.0675351,52.10014
1037,671324,47259,86468,401023,487491,259492,126571,63229,325384,156481,70836,65892,29910,7607,34541,.7308872,.7620391,.3459083,.0879747,.6470751,.3156203,.1576693,30.84088
1038,16453,1155,1722,9791,11513,4208,1220,580,5227,1418,629,1019,198,49,769,.6658009,.5917538,.1149826,.0284553,.4297825,.1246042,.0592381,46.94554
1039,80546,6630,11284,46380,57664,26714,11153,6044,35196,14678,6699,8482,3525,655,4446,.6705883,.7516838,.3123892,.0580468,.575981,.24047,.1303148,35.30011
1040,30170,2464,3433,16676,20109,7162,1766,665,9354,2270,722,2192,504,57,1528,.6201299,.6385086,.1468104,.0166036,.4294795,.1059007,.0398777,56.77119
1041,76283,8964,21086,35970,57056,22349,12489,7777,41178,25414,9523,18829,12925,1746,7644,.8527443,.8929622,.6129659,.0828038,.6213233,.347206,.216208,42.51073
1042,46005,3597,5594,26034,31628,13197,4925,2277,16805,5751,2394,3608,826,117,2307,.6413678,.6449767,.1476582,.0209153,.506914,.1891757,.0874626,49.06786
1043,13253,1283,1666,6312,7978,2683,961,430,3715,1224,470,1032,263,40,982,.7653936,.6194478,.1578631,.0240096,.4250634,.1522497,.0681242,76.94733
1044,26829,2684,4894,13949,18843,7569,4397,2526,11608,6779,2872,4039,2382,346,2272,.8464978,.8252963,.4867184,.0706988,.5426195,.3152197,.1810883,60.51723
1045,196966,17001,28847,110053,138900,77154,42436,23506,98481,51704,25065,21327,9268,1559,11776,.6926652,.7393143,.3212813,.0540437,.7010622,.385596,.213588,29.39149
1046,25047,2060,2733,13756,16489,6629,2388,1207,8510,3059,1385,1881,671,178,1650,.8009709,.6882547,.2455177,.0651299,.4818988,.173597,.0877435,63.18445
1047,30041,2134,3387,17924,21311,7577,2383,1085,9633,2866,1158,2056,483,73,1288,.6035614,.6070269,.1426041,.021553,.4227293,.1329502,.0605334,52.7599
1048,65622,4844,7545,39097,46642,19584,7637,3377,24675,9031,3651,5091,1394,274,3197,.6599917,.6747515,.1847581,.0363154,.500908,.1953347,.0863749,41.13768
1049,364980,28401,49454,200918,250372,123872,54001,24926,159197,67324,27319,35325,13323,2393,19302,.679624,.7143002,.2694019,.0483884,.6165301,.2687714,.1240606,31.98251
1050,22651,1794,2436,12314,14750,6235,2175,1068,7732,2758,1179,1497,583,111,1273,.7095875,.614532,.2393268,.0455665,.5063342,.1766282,.0867305,62.36896
1051,197038,15507,27063,110081,137144,73540,39199,21989,94022,48280,23788,20482,9081,1799,11185,.7212871,.7568266,.3355504,.0664745,.6680535,.3560923,.1997529,36.75657
1052,90231,6706,10391,52269,62660,31318,13007,6164,38489,15193,6610,7171,2186,446,4246,.6331643,.6901165,.2103744,.0429218,.5991697,.2488473,.1179284,36.46137
1053,15012,1481,1929,7858,9787,3390,1374,762,4873,1895,842,1483,521,80,1203,.812289,.7687921,.2700881,.0414723,.4314075,.1748537,.0969712,75.13681
1054,21481,1698,2398,12110,14508,5310,1694,844,6972,2021,899,1662,327,55,1159,.6825677,.6930776,.1363636,.0229358,.4384806,.1398844,.0696945,58.91557
1055,28050,2928,5237,14933,20170,7081,3102,1690,11536,5635,1972,4455,2533,282,2329,.7954235,.8506778,.4836739,.0538476,.4741847,.2077278,.1131722,61.9207
1056,20075,1419,2154,11847,14001,4882,1690,858,6047,1964,891,1165,274,33,991,.6983792,.5408542,.1272052,.0153203,.4120874,.1426522,.0724234,50.72083
1057,47356,3708,5997,26790,32787,11476,3820,1536,15495,5023,1759,4019,1203,223,2359,.636192,.6701684,.2006003,.0371853,.4283688,.1425905,.0573348,49.99789
1058,41205,2925,4630,23642,28272,11801,3854,1519,14655,4498,1648,2854,644,129,1722,.5887179,.6164147,.1390929,.0278618,.4991541,.163015,.0642501,44.42008
1059,66298,4866,8535,36976,45511,23503,11768,6564,29400,14231,6938,5897,2463,374,3347,.687834,.6909198,.2885765,.0438196,.6356285,.3182605,.1775206,45.08377
1060,16908,1592,2498,8546,11044,3971,1657,843,5817,2445,934,1846,788,91,1287,.8084171,.7389912,.3154524,.0364291,.4646618,.1938919,.0986426,73.84322
1061,73826,5620,9106,40547,49653,19923,7158,3154,25436,8584,3427,5513,1426,273,3677,.6542705,.605425,.1566,.0299802,.4913557,.1765359,.0777863,45.34272
1062,38676,2723,4093,22959,27052,11092,4193,1904,13555,5072,2051,2463,879,147,1757,.6452442,.6017591,.2147569,.035915,.4831221,.1826299,.0829304,40.67229
1063,137541,12924,26458,73683,100141,44250,21295,12237,66305,34276,14379,22055,12981,2142,10209,.7899257,.8335853,.4906267,.0809585,.6005456,.2890083,.1660763,40.56952
1064,68660,4837,7839,40222,48061,18352,5700,2564,23126,6891,2745,4774,1191,181,3078,.6363449,.6090062,.1519326,.0230897,.4562677,.1417135,.0637462,44.65673
1065,16821,1378,1967,8971,10938,4168,1132,489,5495,1411,528,1327,279,39,930,.6748912,.6746314,.1418404,.0198271,.4646082,.1261844,.054509,54.22368
1066,14755,1249,1646,7574,9220,3151,1299,717,4134,1563,759,983,264,42,840,.672538,.5972053,.1603888,.0255164,.4160285,.1715078,.094666,78.65428
1067,21953,1600,2249,12943,15192,5553,1716,675,6943,2075,735,1390,359,60,1047,.654375,.6180525,.1596265,.0266785,.429035,.1325813,.0521517,50.54373
2001,7768,742,2063,3744,5807,2887,1343,574,4561,1671,639,1674,328,65,269,.3625337,.8114396,.1589918,.0315075,.7711004,.3587073,.153312,28.93401
2002,7768,742,2063,3744,5807,2887,1343,574,4561,1671,639,1674,328,65,269,.3625337,.8114396,.1589918,.0315075,.7711004,.3587073,.153312,13.45054
2003,174431,12699,26610,93020,119630,82181,45311,21984,104097,51258,22873,21916,5947,889,7804,.6145366,.8236002,.2234874,.0334085,.8834767,.4871103,.2363363,15.29646
2004,10999,1005,1615,4812,6427,2207,1148,661,3158,1366,747,951,218,86,734,.7303482,.5888545,.1349845,.0532508,.458645,.2385702,.1373649,12.3916
2005,1094,70,250,601,851,492,231,99,706,291,112,214,60,13,57,.8142857,.856,.24,.052,.8186356,.3843594,.1647255,8.492275
2006,4616,440,703,2129,2832,1200,585,345,1663,696,387,463,111,42,292,.6636364,.658606,.1578947,.059744,.5636449,.2747769,.1620479,25.46012
2007,53983,3858,9181,28062,37243,24300,12640,6165,32085,15069,6460,7785,2429,295,2324,.6023846,.8479468,.2645681,.0321316,.8659397,.4504312,.2196921,20.98931
2008,1680,136,159,960,1119,748,373,190,895,430,201,147,57,11,101,.7426471,.9245283,.3584906,.0691824,.7791666,.3885417,.1979167,22.27682
2009,19528,1217,2411,11229,13640,10231,6412,3808,12268,6992,3967,2037,580,159,786,.6458505,.8448777,.2405641,.0659477,.911123,.5710214,.3391219,21.14061
2010,25282,1689,2974,13694,16668,11235,5231,2216,13429,5740,2291,2194,509,75,1160,.6867969,.737727,.17115,.0252186,.8204323,.3819921,.1618227,8.232191
2011,11316,872,1413,6353,7766,5225,2520,1127,6326,2773,1198,1101,253,71,588,.6743119,.7791932,.1790517,.0502477,.8224461,.396663,.1773965,9.686411
2012,9939,703,1666,5224,6890,4093,2080,926,5412,2416,1002,1319,336,76,406,.5775249,.7917167,.2016807,.0456182,.7834992,.3981623,.1772588,30.23455
2014,17816,1255,1770,9634,11404,7843,3951,1708,9208,4296,1772,1365,345,64,878,.6996016,.7711864,.1949152,.0361582,.8140959,.41011,.1772888,28.65109
2015,6537,566,938,3058,3996,1665,822,420,2195,950,453,530,128,33,412,.7279152,.565032,.1364606,.0351812,.5444735,.2688031,.1373447,31.10769
2016,4199,386,666,2068,2734,1167,600,261,1586,647,269,419,47,8,210,.5440415,.6291291,.0705706,.012012,.5643134,.2901354,.1262089,82.45859
2018,3822,309,513,1961,2474,1355,539,197,1705,653,221,350,114,24,168,.5436893,.6822612,.2222222,.0467836,.690974,.2748598,.1004589,50.36776
2019,7803,578,1147,4126,5273,3348,1774,874,4210,2043,887,862,269,13,359,.6211073,.7515257,.2345248,.0113339,.8114396,.4299564,.2118274,8.473246
2020,3478,255,399,1873,2272,1328,557,275,1633,595,277,305,38,2,180,.7058824,.764411,.0952381,.0050125,.7090229,.2973839,.1468233,65.32374
2021,5676,423,892,2777,3669,2211,937,425,2906,1045,437,695,108,12,249,.5886525,.779148,.1210762,.0134529,.7961829,.3374145,.1530429,49.56868
2022,8348,605,1080,4687,5767,3764,1854,733,4596,2037,752,832,183,19,341,.5636364,.7703704,.1694444,.0175926,.8030723,.3955622,.15639,75.49081
2023,4665,446,688,1868,2556,646,278,143,1002,369,179,356,91,36,323,.7242153,.5174419,.1322674,.0523256,.3458244,.1488223,.0765525,59.35649
2024,6167,443,725,3425,4150,2641,1364,605,3243,1521,655,602,157,50,272,.6139955,.8303449,.2165517,.0689655,.7710949,.3982482,.1766423,93.07167
2025,7873,621,1065,4015,5080,2687,1241,539,3383,1412,576,696,171,37,434,.6988728,.6535211,.1605634,.0347418,.6692404,.3090909,.1342466,
3001,52108,4886,6557,22275,28832,10981,5432,2319,14260,6319,2429,3279,887,110,2985,.6109292,.5000762,.1352753,.016776,.4929742,.2438608,.1041077,66.0539
3002,85686,6416,10367,48096,58463,33091,16376,6650,40803,18824,7041,7712,2448,391,4450,.6935785,.7438989,.2361339,.0377158,.6880198,.3404857,.1382651,24.87068
3003,75008,7647,16049,34435,50484,25617,15160,8002,39122,22736,8733,13505,7576,731,5666,.7409441,.8414854,.4720543,.045548,.7439233,.4402497,.2323798,34.77553
3004,37080,2474,3533,21672,25205,13365,5061,1694,15636,5537,1762,2271,476,68,1553,.6277284,.6427965,.1347297,.0192471,.6166943,.2335271,.0781654,29.21829
3005,22862,2000,2946,11784,14730,7135,3315,1176,9259,4061,1223,2124,746,47,1465,.7325,.7209776,.2532247,.0159538,.605482,.2813137,.0997963,35.83064
3006,11406,715,1200,5853,7053,3998,1604,581,4934,1858,617,936,254,36,467,.6531469,.78,.2116667,.03,.6830685,.2740475,.0992653,22.92434
3007,1509052,111484,203981,880920,1084901,660880,353415,161232,817174,420018,172457,156294,66603,11225,71326,.6397869,.7662184,.3265157,.0550296,.7502157,.4011885,.1830268,20.9282
3008,55865,3438,5284,36262,41546,25052,9778,3204,28832,10620,3272,3780,842,68,1820,.5293775,.7153671,.159349,.012869,.6908609,.2696487,.088357,24.66245
3009,67629,5722,8044,31202,39246,18638,8629,3501,23511,9799,3653,4873,1170,152,3399,.594023,.6057931,.14545,.0188961,.5973335,.2765528,.1122043,52.00044
3010,531443,39753,78270,310585,388855,231724,129410,64296,294793,160291,70227,63069,30881,5931,27626,.6949413,.8057877,.3945445,.0757762,.7460888,.4166653,.2070158,20.23236
3011,90918,6869,11068,49996,61064,27503,11492,4625,34139,13321,4864,6636,1829,239,4091,.5955743,.5995663,.1652512,.0215938,.550104,.2298584,.0925074,38.99426
3012,20459,1637,2016,10900,12916,5890,3142,1435,7077,3453,1500,1187,311,65,1207,.7373244,.5887897,.1542659,.0322421,.5403669,.2882569,.1316514,35.74834
3013,68145,4205,5944,45532,51476,33628,16484,7368,38403,18270,7531,4775,1786,163,3062,.7281808,.8033311,.3004711,.0274226,.7385575,.3620311,.1618203,23.26754
3014,181108,13464,25110,98758,123868,60830,27046,10754,77232,31116,11438,16402,4070,684,7204,.5350565,.6532059,.1620868,.0272401,.6159501,.2738613,.1088924,24.90828
4001,24175,1671,2677,14603,17280,7128,2495,1176,8901,2798,1241,1773,303,65,1137,.6804309,.6623086,.1131864,.0242809,.4881189,.1708553,.0805314,45.90302
4002,26538,1989,2805,15083,17888,7882,2424,1163,9711,2844,1312,1829,420,149,1426,.7169432,.6520499,.1497326,.0531194,.5225751,.1607107,.0771067,47.21237
4003,27409,1437,1867,19565,21432,11211,3657,1761,12411,3884,1805,1200,227,44,1027,.7146834,.6427424,.1215854,.0235672,.573013,.1869154,.0900077,45.16038
4004,78115,5313,8451,48227,56678,29782,11950,5695,35492,13463,5992,5710,1513,297,3490,.6568794,.6756597,.1790321,.0351438,.6175379,.2477865,.1180874,39.40473
4005,26067,1793,2658,16324,18982,9739,3582,1605,11700,4169,1730,1961,587,125,1195,.6664808,.7377728,.2208427,.0470278,.5966062,.2194315,.0983215,44.08264
4006,13803,999,1344,8480,9824,3950,1220,682,4901,1421,710,951,201,28,661,.6616617,.7075893,.1495536,.0208333,.4658019,.1438679,.0804245,50.99333
4007,6079,543,814,3602,4416,1705,366,149,2326,546,162,621,180,13,370,.6813996,.7628993,.2211302,.0159705,.4733481,.1016102,.0413659,58.79927
4008,16203,960,1481,10763,12244,6145,2369,1056,7128,2581,1106,983,212,50,643,.6697916,.6637407,.1431465,.033761,.5709375,.2201059,.0981139,45.89847
4009,17793,1437,1838,9605,11443,3947,1425,649,5071,1712,714,1124,287,65,1047,.7286013,.6115343,.156148,.0353645,.4109318,.1483602,.067569,67.34337
4010,23326,2334,4609,12932,17541,7232,3438,2048,11039,5536,2312,3807,2098,264,1847,.7913454,.8259926,.4551964,.0572792,.5592329,.2658522,.1583668,47.13569
4011,20616,1462,1946,13116,15062,4983,1379,623,6103,1516,643,1120,137,20,890,.6087551,.5755396,.0704008,.0102775,.3799177,.1051388,.0474992,49.47639
4012,16909,1028,1472,11022,12494,5458,2020,796,6302,2164,822,844,144,26,699,.6799611,.5733696,.0978261,.017663,.4951914,.1832698,.0722192,57.21098
4013,7868,578,774,4773,5547,2175,577,286,2694,681,315,519,104,29,413,.7145329,.6705427,.1343669,.0374677,.4556882,.1208883,.0599204,58.14674
4014,26644,2267,3592,15526,19118,8159,3224,1526,11002,4517,1698,2843,1293,172,1832,.8081164,.7914811,.3599666,.0478842,.5255056,.2076517,.0982867,46.16254
4015,19505,1377,2049,11413,13462,5809,1779,873,7230,2082,919,1421,303,46,919,.6673929,.693509,.147877,.02245,.508981,.1558749,.0764917,52.21636
4016,63239,5566,10545,35370,45915,19091,8703,4691,27452,12717,5415,8361,4014,724,4013,.7209846,.7928876,.3806543,.0686581,.5397512,.246056,.1326265,41.63079
4017,36892,2606,4028,21282,25310,11182,3438,1085,13880,3994,1153,2698,556,68,1591,.6105142,.6698113,.1380338,.0168818,.5254205,.161545,.0509821,46.09004
4018,49499,4213,5895,25586,31481,11808,4357,1864,15028,5281,2009,3220,924,145,2794,.6631854,.5462256,.156743,.0245971,.4615024,.1702884,.0728523,63.3959
4019,20434,1660,2334,11106,13440,4832,1618,824,6273,1944,885,1441,326,61,1100,.6626506,.617395,.1396744,.0261354,.4350801,.145687,.0741941,60.74405
4020,10515,623,1054,6376,7430,3312,1160,562,4061,1348,618,749,188,56,471,.7560192,.7106262,.1783681,.0531309,.5194479,.1819322,.088143,57.58924
4021,19760,1522,2340,10619,12959,4909,1885,935,6427,2289,1030,1518,404,95,929,.6103811,.6487179,.1726496,.0405983,.4622846,.177512,.0880497,59.62214
4022,17910,1633,2628,9901,12529,5110,2326,1272,7204,3171,1383,2094,845,111,1275,.7807716,.7968037,.3215373,.0422374,.5161095,.2349258,.1284719,55.92202
4023,46192,4816,8968,24456,33424,15150,6852,3543,22622,10496,4051,7472,3644,508,3702,.7686877,.8331847,.4063336,.0566459,.6194799,.2801766,.1448724,45.3821
4024,14705,1263,1630,8828,10458,4515,1429,542,5598,1673,595,1083,244,53,768,.608076,.6644172,.1496933,.0325153,.5114409,.1618713,.0613956,50.21872
4025,9975,571,797,6502,7299,3164,899,347,3697,946,364,533,47,17,389,.6812609,.6687579,.0589711,.02133,.4866195,.1382651,.0533682,63.32052
4026,70531,4622,6864,46293,53157,27709,11521,5245,32117,12907,5514,4408,1386,269,3089,.6683254,.6421912,.2019231,.03919,.598557,.2488713,.1133001,39.00112
4027,13008,1009,1441,7730,9171,4131,1172,568,5026,1346,587,895,174,19,686,.6798811,.6210964,.1207495,.0131853,.5344114,.1516171,.07348,46.53896
4028,30744,2217,3298,18523,21821,8295,2697,1359,10247,3140,1454,1952,443,95,1448,.6531349,.5918739,.1343238,.0288053,.4478216,.1456028,.0733682,49.75391
4029,23635,1572,2389,14270,16659,8026,2534,1254,9642,2897,1289,1616,363,35,926,.5890585,.6764337,.1519464,.0146505,.5624387,.1775753,.0878767,52.37788
4030,26819,1934,2755,16293,19048,8801,2876,1330,10706,3273,1390,1905,397,60,1391,.7192348,.69147,.1441016,.0217786,.5401706,.1765175,.0816301,37.14945
4031,13459,1025,1294,8157,9451,3922,1222,580,4782,1372,629,860,150,49,566,.5521951,.6646059,.1159196,.0378671,.480814,.14981,.0711046,46.5284
4032,30147,2114,3485,18107,21592,9091,3112,1480,11439,3782,1621,2348,670,141,1324,.6263009,.6737446,.1922525,.0404591,.502071,.1718672,.0817363,55.91365
4033,10768,641,774,7491,8265,3830,1380,646,4301,1444,654,471,64,8,452,.7051482,.6085271,.0826873,.0103359,.5112802,.1842211,.0862368,60.48956
4034,21646,1512,2235,12971,15206,5347,1911,1040,6674,2229,1136,1327,318,96,897,.593254,.593736,.1422819,.042953,.4122273,.1473287,.0801789,46.60654
4035,90718,7632,12224,50229,62453,28929,11796,5994,37420,14773,6450,8491,2977,456,4991,.653957,.6946172,.2435373,.0373037,.5759422,.2348444,.1193335,47.88948
4036,17423,1221,1956,10666,12622,5098,2009,932,6283,2461,1004,1185,452,72,790,.6470106,.6058282,.2310838,.0368098,.4779674,.1883555,.0873805,53.43197
4037,10213,751,981,6011,6992,2474,729,341,3065,855,362,591,126,21,537,.7150466,.6024465,.1284404,.0214067,.4115788,.1212777,.0567293,59.29807
4038,18447,1308,2047,11256,13303,4611,1378,618,6004,1706,661,1393,328,43,862,.6590214,.6805081,.1602345,.0210064,.4096482,.1224236,.0549041,60.56177
4039,15539,1299,1635,8243,9878,2630,1167,584,3456,1408,607,826,241,23,913,.7028483,.5051988,.1474006,.0140673,.3190586,.1415747,.070848,71.60867
4040,13369,1089,1711,7798,9509,3247,968,444,4225,1189,459,978,221,15,687,.630854,.5715955,.1291642,.0087668,.4163888,.1241344,.0569377,62.44121
4041,13952,1022,1492,7892,9384,4119,1521,607,5157,1782,630,1038,261,23,721,.7054794,.6957105,.174933,.0154155,.5219209,.1927268,.0769133,55.24483
4042,20144,1582,1953,12171,14124,5660,1652,763,6765,1861,802,1105,209,39,1144,.7231353,.5657962,.1070148,.0199693,.4650398,.1357325,.06269,55.05943
4043,34518,2570,3659,19451,23110,10376,3582,1559,12784,4125,1630,2408,543,71,1761,.685214,.6581033,.1484012,.0194042,.533443,.1841551,.0801501,55.25238
4044,11373,744,1071,7078,8149,3387,1046,440,4102,1144,454,715,98,14,469,.6303763,.6676004,.0915033,.0130719,.478525,.1477819,.0621645,61.22181
4045,11334,676,842,7460,8302,4191,1417,540,4692,1522,567,501,105,27,494,.7307692,.5950119,.1247031,.0320665,.5617962,.1899464,.0723861,55.29992
4046,37766,2645,4217,21930,26147,12040,4389,1705,14914,5151,1832,2874,762,127,1634,.6177694,.6815271,.1806972,.0301162,.5490196,.2001368,.0777474,46.45344
4047,59517,4542,7885,31503,39388,14762,5676,2721,19892,6745,2921,5130,1069,200,2655,.5845442,.6506024,.1355739,.0253646,.4685903,.1801733,.0863727,59.18905
4048,14052,1099,1399,8014,9413,3190,1138,488,4054,1336,535,864,198,47,793,.7215651,.617584,.1415297,.0335954,.3980534,.1420015,.0608934,67.09931
4049,7771,516,746,5061,5807,2405,760,393,2750,803,406,345,43,13,313,.6065891,.4624665,.0576407,.0174263,.4752025,.150168,.0776526,51.05588
4050,11097,742,1159,6709,7868,3220,944,450,4003,1083,464,783,139,14,454,.6118599,.6755824,.119931,.0120794,.4799523,.1407065,.0670741,57.83323
4051,7756,535,794,4651,5445,2105,714,321,2555,808,326,450,94,5,329,.6149533,.5667506,.1183879,.0062972,.4525909,.1535154,.0690174,73.03766
4052,30541,2215,3126,18704,21830,9719,3667,1703,11837,4225,1851,2118,558,148,1628,.7349887,.6775432,.1785029,.0473448,.5196215,.1960543,.09105,44.67363
4053,7266,510,657,4356,5013,2232,603,243,2639,717,259,407,114,16,382,.7490196,.6194825,.173516,.0243531,.5123967,.1384297,.0557851,62.10075
4054,34772,2993,3739,18357,22096,7656,3414,1525,9706,4219,1652,2050,805,127,2219,.7413966,.5482749,.2152982,.0339663,.4170616,.1859781,.0830746,62.65526
4055,10373,732,1054,6350,7404,3062,919,456,3791,1030,492,729,111,36,450,.6147541,.6916509,.1053131,.0341556,.4822047,.1447244,.071811,53.85487
4056,27032,2156,3047,15696,18743,6189,1967,979,7875,2288,1057,1686,321,78,1245,.5774583,.5533311,.1053495,.025599,.3943043,.1253186,.0623726,58.40194
4057,17007,1181,1468,10640,12108,5308,1841,857,6318,1963,890,1010,122,33,768,.6502963,.6880109,.0831063,.0224796,.4988722,.1730263,.0805451,47.7607
4058,39021,3373,5676,22126,27802,12729,5258,2608,17080,7068,2906,4351,1810,298,2335,.6922621,.766561,.3188865,.0525018,.575296,.237639,.1178704,46.94405
4059,10140,792,1021,6038,7059,2582,797,395,3302,967,459,720,170,64,568,.7171717,.705191,.1665034,.0626836,.427625,.1319973,.065419,50.70755
4060,340613,23387,45288,195502,240790,140160,70139,36849,174542,83068,40394,34382,12929,3545,15982,.6833711,.7591857,.285484,.0782768,.7169236,.3587636,.188484,28.47532
4061,16834,1244,1699,10179,11878,4299,1354,644,5347,1495,691,1048,141,47,783,.6294212,.6168334,.08299,.0276633,.4223401,.133019,.0632675,53.55946
4062,30858,2471,3308,16162,19470,7281,2715,1299,9403,3288,1397,2122,573,98,1609,.6511534,.6414752,.1732164,.0296252,.4505012,.1679866,.0803737,69.18958
4063,53161,4060,5739,30997,36736,18656,6088,2552,22427,6948,2723,3771,860,171,2518,.6201971,.6570831,.1498519,.0297961,.6018647,.1964061,.0823305,29.12153
4064,9685,740,928,6028,6956,2557,696,226,3056,792,252,499,96,26,469,.6337838,.5377155,.1034483,.0280172,.4241871,.1154612,.0374917,60.25554
4065,8847,629,775,5598,6373,2327,793,397,2873,888,403,546,95,6,402,.6391097,.7045161,.1225806,.0077419,.4156842,.1416577,.0709182,64.45129
4066,95172,6579,11357,56606,67963,36439,16422,6761,44425,19134,7282,7986,2712,521,4232,.6432589,.7031786,.2387955,.0458748,.6437303,.2901106,.1194396,31.14722
4067,14060,957,1358,8535,9893,4483,1581,726,5276,1771,763,793,190,37,660,.6896552,.583947,.1399116,.0272459,.525249,.1852373,.0850615,43.14009
4068,14607,918,1211,9713,10924,5218,1733,798,5992,1869,828,774,136,30,567,.6176471,.6391412,.1123039,.0247729,.5372182,.1784207,.0821579,62.54052
4069,9022,673,804,5683,6487,2383,728,398,2858,801,402,475,73,4,450,.6686478,.590796,.090796,.0049751,.4193208,.1281013,.0700334,67.59603
4070,48573,3393,5181,29504,34685,17114,6786,3150,20570,7738,3378,3456,952,228,2169,.6392573,.6670527,.1837483,.0440069,.580057,.2300027,.1067652,36.6033
4071,13357,783,1064,8746,9810,4580,1526,597,5232,1673,619,652,147,22,502,.6411239,.6127819,.1381579,.0206767,.523668,.1744798,.0682598,62.79004
4072,100494,9671,20195,54724,74919,34899,17525,9831,51879,27106,11634,16980,9581,1803,7368,.7618654,.8408022,.4744244,.0892795,.6377275,.3202434,.179647,34.66954
4073,50835,4555,7694,28737,36431,13967,5287,2540,19994,8176,2946,6027,2889,406,3314,.7275521,.7833377,.3754874,.0527684,.4860285,.1839788,.0883878,46.873
4074,11222,921,1139,6473,7612,2484,871,453,3111,1007,495,627,136,42,601,.6525516,.5504829,.119403,.0368745,.3837479,.1345589,.069983,66.27509
4075,17026,1133,1684,10646,12330,5183,1459,535,6306,1807,603,1123,348,68,797,.7034422,.6668646,.2066508,.04038,.4868495,.1370468,.0502536,53.01746
5001,1105379,78218,150731,677511,828242,514975,299882,151045,638163,359348,162609,123188,59466,11564,57550,.7357641,.8172705,.3945174,.0767195,.7600983,.4426231,.222941,14.4108
5002,1097,88,184,611,795,526,341,198,697,424,215,171,83,17,59,.6704546,.9293478,.451087,.0923913,.8608838,.5581015,.3240589,32.71276
5003,19314,1273,2008,12864,14872,9877,4386,1626,11218,4682,1674,1341,296,48,848,.6661429,.6678287,.1474104,.0239044,.7678016,.3409515,.1263992,16.58463
5004,143851,10612,23194,87231,110425,62488,33901,14742,82629,46297,16561,20141,12396,1819,8116,.7647946,.8683711,.5344486,.0784255,.7163509,.3886348,.1689996,19.16839
5005,20710,1331,1778,13898,15676,10605,4975,1915,11922,5349,1974,1317,374,59,870,.6536439,.7407199,.2103487,.0331834,.7630594,.3579652,.1377896,15.03208
5006,12791,961,1338,7688,9026,4969,2404,947,5833,2717,953,864,313,6,693,.7211238,.6457399,.2339312,.0044843,.646332,.3126951,.123179,22.04592
5007,656380,47899,75325,400358,475683,327106,197652,101933,386009,222730,106303,58903,25078,4370,36058,.7527924,.7819847,.3329306,.0580153,.8170338,.4936881,.2546046,10.61357
5008,18217,1224,2099,10884,12983,7305,3017,1097,8612,3315,1123,1307,298,26,705,.5759804,.6226774,.1419724,.0123869,.6711687,.2771959,.1007902,14.36999
5009,85812,5321,9388,54386,63774,44140,23662,9483,51455,26175,9846,7315,2513,363,3652,.6863372,.7791862,.2676821,.0386664,.8116059,.4350752,.1743647,11.41381
5010,514621,39804,71994,288850,360844,184136,101681,43785,234471,125687,47634,50335,24006,3849,27647,.6945784,.6991555,.3334444,.0534628,.6374797,.3520201,.1515839,23.91341
5011,21350,1589,2356,12664,15020,7984,3382,1181,9563,3867,1224,1579,485,43,1135,.7142857,.6702037,.2058574,.0182513,.6304485,.2670562,.0932565,18.73716
5012,108514,7635,17241,63980,81221,48910,26812,11537,63684,34292,12739,14774,7480,1202,5436,.7119843,.8569108,.4338495,.0697175,.7644576,.4190685,.180322,12.83881
5013,92110,7519,11681,48112,59793,24465,12559,4616,32049,15576,4878,7584,3017,262,5303,.7052799,.6492595,.2582827,.0224296,.508501,.2610368,.0959428,26.17759
5014,17895,1069,1559,11646,13205,8636,3725,1416,9851,4092,1472,1215,367,56,642,.6005613,.7793458,.2354073,.0359205,.7415422,.3198523,.1215868,18.1551
5015,403089,30435,53067,225411,278478,139919,69292,26674,174380,81095,28312,34461,11803,1638,18558,.6097585,.6493866,.2224169,.0308666,.6207284,.3074029,.1183349,21.3029
5016,73738,5840,10786,38517,49303,22601,9966,3910,29753,12057,4105,7152,2091,195,3570,.6113014,.6630818,.1938624,.018079,.5867799,.2587429,.1015136,30.86366
5017,36366,1811,2678,25685,28363,17059,7059,2616,18854,7623,2684,1795,564,68,1166,.6438432,.6702763,.2106049,.0253921,.664162,.2748297,.1018493,22.32625
5018,21661,1656,3136,12584,15720,9202,4784,1499,11437,5623,1554,2235,839,55,1214,.7330918,.7126913,.2675383,.0175383,.7312461,.3801653,.1191195,13.99051
5019,7477503,531289,1019013,4430503,5449516,3094462,1758297,818658,3807453,2097024,879585,712991,338727,60927,365817,.6885462,.6996878,.3324069,.0597902,.6984448,.3968617,.1847777,13.01469
5020,63116,4314,6952,36023,42975,21651,10262,3871,25950,11512,4102,4299,1250,231,2612,.6054705,.6183832,.1798044,.0332278,.6010327,.2848735,.1074591,29.6714
5021,222568,13451,22596,149763,172359,134630,97798,57301,153444,107300,59185,18814,9502,1884,10793,.8023939,.8326253,.4205169,.0833776,.8989537,.6530184,.3826112,8.651519
5022,11108,707,1229,7230,8459,5330,2800,1115,6280,3273,1198,950,473,83,518,.7326733,.7729862,.3848657,.0675346,.7372061,.3872752,.1542185,24.85561
5023,66738,3986,6718,41424,48142,31637,15988,7305,36596,17306,7426,4959,1318,121,2464,.6181636,.7381661,.1961893,.0180113,.763736,.3859598,.176347,17.90432
5024,134560,11296,19375,71262,90637,43019,20799,7462,56177,24977,7832,13158,4178,370,7267,.6433251,.6791226,.2156387,.0190968,.6036738,.2918666,.1047122,26.58184
5025,8610,602,711,5481,6192,3963,1958,677,4466,2104,693,503,146,16,454,.7541528,.7074543,.2053446,.0225035,.7230433,.3572341,.1235176,14.06439
5026,8577,564,1450,4985,6435,4399,2509,1132,5617,2952,1202,1218,443,70,287,.5088652,.84,.3055173,.0482759,.8824474,.5033099,.2270812,8.844766
5027,290444,22954,46762,161406,208168,114544,67312,31642,146062,77492,33057,31518,10180,1415,12057,.5252679,.6740088,.2176981,.0302596,.7096638,.4170353,.1960398,19.65803
5028,99199,7347,11683,63125,74808,47583,26044,11210,56477,30147,11663,8894,4103,453,5772,.7856268,.7612771,.3511941,.0387743,.7537901,.4125782,.1775842,12.72245
5029,51645,2938,4316,34380,38696,28191,14514,6186,31643,15597,6249,3452,1083,63,2087,.7103472,.7998146,.2509268,.0145968,.8199825,.4221641,.1799302,17.73043
5030,1932709,150592,277067,1130822,1407889,908825,548011,255992,1123024,644348,272115,214199,96337,16123,107156,.711565,.7730946,.3477029,.0581917,.8036853,.484613,.2263769,10.40373
5031,117247,8756,12875,72167,85042,55890,29743,12030,66133,33570,12384,10243,3827,354,6356,.7259023,.7955728,.2972427,.0274951,.7744537,.4121413,.1666967,14.81005
5032,17340,1058,1666,10976,12642,8610,4174,1593,9949,4537,1615,1339,363,22,697,.6587902,.8037215,.2178871,.0132053,.7844388,.3802842,.1451348,17.15406
5033,663166,45073,76518,402258,478776,277192,137761,51303,330267,156215,53974,53075,18454,2671,29622,.6572005,.6936277,.241172,.0349068,.6890901,.3424693,.1275375,18.88567
5034,783381,57622,108304,465032,573336,362510,203316,89581,449223,241795,95892,86713,38479,6311,40488,.7026483,.8006445,.355287,.0582712,.7795377,.4372086,.1926341,11.00673
5035,25005,1971,2856,13829,16685,7814,4118,1471,9552,4620,1531,1738,502,60,1301,.660071,.6085434,.1757703,.0210084,.5650445,.29778,.1063707,22.61546
5036,895016,65820,120130,504634,624764,358486,177712,66179,446615,208033,70330,88129,30321,4151,41261,.6268764,.7336136,.2524016,.0345542,.7103881,.3521602,.1311426,16.86885
5037,1861846,149298,313379,1073232,1386611,837128,481493,223845,1083621,576237,240158,246493,94744,16313,89030,.5963241,.7865651,.3023304,.0520552,.7800066,.4486383,.2085709,14.76971
5038,678974,34235,83781,479341,563122,354548,234092,135263,423823,276262,147208,69275,42170,11945,25972,.7586388,.8268581,.5033361,.1425741,.7396572,.4883621,.2821853,15.50001
5039,347342,26342,44446,201817,246263,126423,61471,23256,157815,74448,24832,31392,12977,1576,18508,.7026042,.7062953,.2919723,.0354588,.626424,.3045878,.1152331,19.48736
5040,155435,12190,29137,92531,121668,71072,40192,17561,96142,55838,19602,25070,15646,2041,9341,.7662838,.860418,.5369805,.0700484,.7680885,.4343625,.189785,19.17532
5041,587329,38461,69309,379077,448386,309237,189998,96491,365722,218028,101952,56485,28030,5461,29147,.7578326,.8149735,.4044208,.0787921,.815763,.5012122,.254542,7.020627
5042,298694,25157,49823,176452,226275,139629,86324,43428,181390,109004,47055,41761,22680,3627,19048,.757165,.8381872,.4552115,.0727977,.7913144,.4892209,.2461179,13.20701
5043,1295071,100621,183919,753603,937522,599153,381589,198702,743210,453583,213907,144057,71994,15205,72893,.7244313,.7832633,.3914441,.0826723,.7950512,.5063528,.2636693,10.58081
5044,188141,12575,26064,116806,142870,90863,57495,27419,111267,68361,29132,20404,10866,1713,9019,.7172167,.7828422,.4168969,.0657228,.7778967,.4922264,.2347397,20.79815
5045,115715,8211,12724,69567,82291,52599,24755,8630,62459,27928,8823,9860,3173,193,5908,.7195226,.7749135,.2493713,.0151682,.7560912,.355844,.1240531,15.45531
5046,3073,173,287,2050,2337,1601,850,368,1834,905,371,233,55,3,107,.6184971,.8118467,.1916376,.010453,.7809756,.4146341,.1795122,14.48335
5047,39732,2569,3859,24816,28675,18760,9070,3491,21785,10189,3597,3025,1119,106,1769,.6885948,.7838818,.2899715,.0274683,.7559639,.36549,.1406754,14.79019
5048,235203,17347,31862,131554,163416,101097,49931,18001,126149,57279,18634,25052,7348,633,11775,.6787917,.7862658,.2306195,.0198669,.7684829,.3795476,.1368335,16.38098
5049,299681,20308,33287,188012,221299,145819,80844,36235,171830,91119,37539,26011,10275,1304,14050,.6918456,.7814162,.3086791,.0391745,.7755834,.4299938,.1927271,18.57595
5050,265900,19867,33974,152647,186621,94638,46446,17954,116692,54129,18966,22054,7683,1012,12220,.6150904,.6491435,.2261435,.0297875,.6199794,.3042706,.1176178,22.35674
5051,52246,4139,6618,30192,36810,20441,10590,4351,25039,12090,4542,4598,1500,191,2830,.68374,.6947718,.2266546,.0288607,.6770337,.3507552,.144111,18.29186
5052,38888,2883,3993,24042,28035,16704,6616,2180,19593,7419,2228,2889,803,48,1927,.6684009,.7235162,.2011019,.012021,.6947841,.2751851,.0906747,17.45938
5053,11858,712,904,7554,8458,5625,2727,1028,6334,2841,1028,709,114,0,501,.7036517,.784292,.1261062,0,.7446386,.3610008,.1360868,11.12396
5054,245738,19093,30537,134859,165396,75208,36541,13639,93518,42718,14235,18310,6177,596,12181,.6379825,.5996005,.2022792,.0195173,.5576788,.2709571,.1011353,28.36994
5055,33928,1999,3594,21833,25427,16868,8364,2981,19486,9307,3122,2618,943,141,1225,.6128064,.7284363,.2623817,.0392321,.7725919,.3830898,.1365364,16.14149
5056,529174,42009,66579,297293,363872,225785,126254,53980,273832,144345,56352,48047,18091,2372,29408,.7000405,.721654,.2717223,.0356269,.7594696,.4246787,.1815717,15.37834
5057,113374,10950,24032,61455,85487,45141,27304,16611,66148,40957,19459,21007,13653,2848,8982,.820274,.8741261,.5681175,.1185087,.7345375,.4442926,.2702954,14.91845
5058,49733,3993,7464,27073,34537,17272,7976,2523,22767,9555,2616,5495,1579,93,2357,.590283,.7362005,.2115488,.0124598,.6379788,.2946109,.0931925,21.40629
6001,245944,19704,36597,130918,167515,96243,39058,14161,122864,46377,15558,26621,7319,1397,12231,.6207369,.7274094,.1999891,.0381725,.7351395,.2983394,.1081669,11.76715
6002,11799,1205,2296,6022,8318,4269,2347,1238,6170,3303,1383,1901,956,145,941,.7809129,.8279617,.4163763,.0631533,.7089007,.3897376,.2055795,29.90961
6003,293621,20843,33931,171038,204969,151515,97094,54641,178495,108501,57653,26980,11407,3012,14747,.7075277,.7951431,.3361823,.0887684,.8858558,.567675,.319467,9.566225
6004,3664,299,340,2148,2488,1554,933,479,1771,1011,493,217,78,14,228,.7625418,.6382353,.2294118,.0411765,.7234637,.4343576,.2229981,47.85611
6005,5419,394,564,3295,3859,2049,904,409,2468,1027,423,419,123,14,286,.7258883,.7429078,.2180851,.0248227,.6218513,.2743551,.1241275,30.696
6006,5945,370,521,3673,4194,2236,1053,365,2602,1153,370,366,100,5,286,.772973,.7024952,.1919386,.0095969,.6087667,.2866866,.0993738,28.97677
6007,189625,16814,36422,105961,142383,92653,62357,38585,124675,81712,42759,32022,19355,4174,13489,.8022481,.8791939,.5314096,.1146011,.8744066,.5884901,.3641434,15.12855
6008,13227,975,1678,7784,9462,5667,2442,1039,6666,2672,1103,999,230,64,564,.5784615,.5953516,.1370679,.0381406,.7280319,.3137205,.1334789,23.40875
6009,2153,152,209,1311,1520,943,356,167,1098,406,182,155,50,15,103,.6776316,.7416268,.2392344,.0717703,.7192982,.2715484,.1273837,20.29808
6010,7308,368,852,4441,5293,3895,2364,1326,4557,2572,1377,662,208,51,184,.5,.7769953,.2441315,.0598592,.8770547,.5323126,.2985814,10.54482
6011,7794,719,807,4045,4852,2103,916,394,2683,1043,402,580,127,8,532,.7399166,.7187113,.157373,.0099133,.5199011,.2264524,.0974042,52.98683
6012,3071,290,317,1775,2092,815,359,180,1035,409,184,220,50,4,205,.7068965,.6940063,.1577287,.0126183,.4591549,.2022535,.1014085,61.86673
6013,2988,201,292,1934,2226,1082,347,166,1279,418,173,197,71,7,131,.6517413,.6746575,.2431507,.0239726,.5594622,.1794209,.0858325,37.81493
6014,1528,111,146,938,1084,741,348,158,839,377,163,98,29,5,68,.6126126,.6712329,.1986301,.0342466,.7899787,.3710021,.1684435,34.60639
6015,21225,1355,1854,13407,15261,9122,3733,1633,10440,4078,1729,1318,345,96,954,.7040591,.7108954,.1860841,.0517799,.6803908,.2784366,.121802,33.08337
6016,492365,31398,71606,309627,381233,231329,138195,76718,284918,163421,83851,53589,25226,7133,18662,.5943691,.748387,.3522889,.0996146,.7471215,.4463274,.2477756,16.36505
6017,1658,128,187,955,1142,615,216,74,753,261,78,138,45,4,84,.65625,.7379679,.2406417,.0213904,.6439791,.226178,.0774869,19.1184
6018,25153,1823,1896,14521,16417,12856,7665,3952,14319,8166,4087,1463,501,135,1416,.7767416,.7716244,.2642405,.0712025,.8853385,.5278562,.2721576,16.1595
6019,13320,831,2485,7852,10337,7038,4663,2716,9208,5689,3007,2170,1026,291,478,.5752106,.8732395,.4128773,.1171026,.8963321,.5938615,.3458991,31.9114
6020,6850,469,510,4022,4532,3084,1288,604,3478,1436,633,394,148,29,360,.7675906,.772549,.2901961,.0568627,.7667827,.3202387,.150174,29.73326
6021,309424,26360,52505,166318,218823,137542,73668,34731,180646,89632,37066,43104,15964,2335,15546,.5897572,.8209504,.3040472,.044472,.826982,.4429346,.2088229,16.72442
6022,28676,1931,2802,18186,20988,12163,4866,2125,14035,5337,2209,1872,471,84,1398,.7239772,.6680942,.1680942,.0299786,.6688112,.2675685,.1168481,24.90177
6023,22514,1570,3146,13113,16259,10542,5695,2647,13016,6606,2817,2474,911,170,997,.6350318,.7863954,.2895741,.0540369,.8039351,.4343018,.2018608,15.41251
6024,2441,156,196,1588,1784,1382,855,407,1523,900,417,141,45,10,117,.75,.7193878,.2295918,.0510204,.8702771,.5384131,.2562972,12.7566
6025,7475,397,1110,4328,5438,3624,1923,916,4592,2432,1079,968,509,163,229,.5768262,.8720721,.4585586,.1468468,.8373383,.4443161,.2116451,20.38328
6026,10689,1472,3648,4987,8635,4485,3216,1976,7998,5368,2250,3513,2152,274,1327,.9014946,.9629934,.5899123,.0751096,.8993383,.6448767,.3962302,24.453
6027,408,19,39,268,307,233,144,82,266,161,83,33,17,1,13,.6842105,.8461539,.4358974,.025641,.869403,.5373135,.3059702,6.944445
6028,6440,450,526,3997,4523,2102,951,451,2468,1090,497,366,139,46,283,.6288889,.6958175,.2642586,.0874525,.5258944,.2379285,.1128346,43.13356
6029,1863,134,218,1080,1298,825,319,145,990,380,152,165,61,7,82,.6119403,.7568808,.2798165,.0321101,.7638889,.2953704,.1342593,12.13434
6030,371753,27536,43406,216320,259726,186496,108298,58029,220112,121722,60960,33616,13424,2931,20266,.735982,.7744551,.309266,.0675252,.8621302,.5006379,.2682554,8.574496
6031,1936,118,178,1304,1482,932,315,116,1077,346,121,145,31,5,79,.6694915,.8146067,.1741573,.0280899,.7147239,.2415644,.0889571,17.82297
6032,7599,519,811,4472,5283,3124,1421,556,3733,1572,595,609,151,39,382,.7360308,.7509248,.1861899,.0480888,.6985689,.3177549,.1243292,21.30961
6033,8830,728,1670,4337,6007,3221,1527,587,4550,1922,647,1329,395,60,364,.5,.7958084,.236527,.0359281,.7426793,.3520867,.135347,16.31571
6034,27424,2625,4983,15198,20181,12122,7086,3366,16359,9204,3649,4237,2118,283,2005,.7638095,.850291,.4250452,.0567931,.7976049,.4662456,.2214765,24.92181
6035,149184,12276,29396,81581,110977,67459,41113,23498,93106,56982,26666,25647,15869,3168,9716,.791463,.8724657,.5398353,.1077698,.826896,.5039531,.2880327,21.03693
6036,14897,1156,1850,8894,10744,5458,2593,1001,6901,3126,1055,1443,533,54,908,.7854671,.78,.2881081,.0291892,.6136721,.2915449,.1125478,40.72792
6037,4663,337,499,2980,3479,2050,789,281,2430,929,301,380,140,20,231,.6854599,.7615231,.2805611,.0400802,.6879194,.2647651,.0942953,18.22358
6038,19800,1815,2912,11118,14030,7782,3405,1382,10171,4315,1462,2389,910,80,1468,.8088154,.8203983,.3125,.0274725,.699946,.3062601,.1243029,16.51254
6039,81530,6119,10914,47185,58099,35130,18247,7696,43382,21425,8175,8252,3178,479,3787,.618892,.7560931,.2911856,.0438886,.7445163,.3867119,.1631027,19.56777
6040,804,67,94,490,584,409,206,112,488,229,123,79,23,11,35,.522388,.8404256,.2446809,.1170213,.8346938,.4204082,.2285714,16.74757
6041,13133,853,1860,7021,8881,5304,2251,1031,6668,2700,1141,1364,449,110,449,.5263775,.7333333,.2413978,.0591398,.7554479,.3206096,.1468452,14.8668
6042,16510,1141,1751,9324,11075,5986,2885,1267,7286,3166,1319,1300,281,52,648,.5679229,.7424329,.1604797,.0296973,.6419991,.3094166,.1358859,27.12221
6043,24352,1883,2513,14365,16878,10035,4665,1988,11741,5044,2054,1706,379,66,1205,.6399363,.6788699,.1508158,.0262634,.6985729,.3247477,.1383919,26.24133
6044,22513,1639,2667,12939,15606,8442,3437,1606,10415,3882,1697,1973,445,91,1149,.7010372,.7397825,.1668541,.0341207,.6524461,.265631,.1241209,22.62252
6045,22567,1866,2597,13012,15609,7804,3531,1565,9590,4050,1612,1786,519,47,1343,.7197213,.6877166,.199846,.0180978,.5997541,.2713649,.1202736,29.90612
6046,1925,142,139,1238,1377,956,507,305,1047,535,315,91,28,10,110,.7746479,.6546763,.2014388,.0719424,.7722132,.4095315,.2463651,25.33724
6047,5333,270,391,3233,3624,2662,1434,608,2907,1504,613,245,70,5,224,.8296296,.6265985,.1790281,.0127877,.8233839,.4435509,.1880606,16.01996
6048,4542,255,408,2865,3273,1978,760,371,2292,834,381,314,74,10,182,.7137255,.7696078,.1813726,.0245098,.6904014,.2652705,.1294939,17.18686
6049,10338,536,1613,6863,8476,6510,5363,3168,7952,6153,3509,1442,790,341,347,.647388,.8939863,.4897706,.2114073,.9485648,.7814367,.4616057,18.23181
6050,13070,982,1402,7293,8695,4769,2248,934,5753,2589,989,984,341,55,676,.688391,.7018545,.243224,.0392297,.6539147,.3082408,.128068,29.38374
6051,125972,9457,15979,73180,89159,48668,22038,9686,60721,26242,10237,12053,4204,551,6778,.7167178,.7543025,.2630953,.0344828,.6650451,.3011478,.1323586,21.16995
6052,6255,551,1032,3269,4301,2591,1302,590,3422,1589,627,831,287,37,367,.6660617,.8052326,.2781008,.0358527,.7925971,.3982869,.1804833,12.29587
6053,10511,826,1191,6029,7220,3740,1846,922,4502,2066,946,762,220,24,556,.6731235,.6397985,.1847187,.0201511,.620335,.3061868,.1529275,38.72703
6054,13404,790,2019,7907,9926,6969,4209,2507,8787,4998,2805,1818,789,298,448,.5670886,.9004458,.3907875,.1475978,.881371,.5323132,.3170608,22.78524
6055,3935,314,466,2232,2698,1323,584,251,1615,634,270,292,50,19,196,.6242038,.6266094,.1072961,.0407725,.5927419,.2616487,.1124552,47.97111
6056,833,54,110,470,580,384,197,114,463,231,133,79,34,19,44,.8148148,.7181818,.3090909,.1727273,.8170213,.4191489,.2425532,29.46745
6057,3192,145,343,1986,2329,1690,1160,712,1974,1290,762,284,130,50,97,.6689655,.8279883,.3790087,.1457726,.8509567,.5840886,.3585096,19.39513
6058,3266,171,288,2072,2360,1386,651,232,1604,724,249,218,73,17,143,.8362573,.7569444,.2534722,.0590278,.6689189,.3141892,.1119691,18.86033
6059,8848,466,1850,5160,7010,4917,3593,1995,6613,4485,2295,1696,892,300,225,.4828326,.9167567,.4821621,.1621622,.952907,.6963179,.3866279,10.2765
6060,8034,568,654,4937,5591,4112,2156,961,4632,2366,1007,520,210,46,414,.7288733,.795107,.3211009,.0703364,.8328944,.4367025,.1946526,21.12618
6061,5304,375,516,3319,3835,2175,813,362,2576,907,397,401,94,35,281,.7493333,.7771318,.1821705,.0678295,.6553178,.2449533,.109069,19.93112
6062,123438,10862,20986,65916,86902,45344,22787,11058,62481,31480,12371,17137,8693,1313,7977,.7343951,.816592,.4142285,.0625655,.6879058,.3456976,.167759,24.84614
6063,9682,602,879,5850,6729,3851,1429,671,4561,1623,735,710,194,64,438,.7275748,.807736,.2207053,.07281,.6582906,.2442735,.1147009,25.74084
7001,807143,58211,87386,502114,589500,366458,209014,130047,435030,242557,138379,68572,33543,8332,44797,.7695625,.7847024,.3838487,.0953471,.7298303,.416268,.258999,9.171024
7002,807766,59950,100497,497275,597772,346646,174234,98440,426012,210757,107857,79366,36523,9417,45116,.7525605,.789735,.3634238,.0937043,.6970912,.3503776,.1979589,8.668344
7003,156769,10434,15648,98414,114062,69462,34641,18320,81481,39261,19481,12019,4620,1161,7680,.7360552,.7680854,.2952454,.0741948,.7058142,.3519926,.1861524,10.0368
7004,129017,9261,15194,80019,95213,58499,29511,16360,70837,34887,17523,12338,5376,1163,7012,.7571536,.8120311,.3538239,.0765434,.7310638,.3687999,.2044514,9.02756
7005,761337,55353,95997,468143,564140,317396,151450,83738,393414,187347,91941,76018,35897,8203,41249,.745199,.7918789,.3739388,.0854506,.6779894,.3235123,.1788727,9.909536
7006,238409,19052,35447,137520,172967,97665,44787,23275,126381,54541,25069,28716,9754,1794,11971,.628333,.8101109,.2751714,.0506108,.7101876,.3256763,.1692481,12.02843
7007,114823,10653,21450,63153,84603,48492,25694,15385,67546,37071,17019,19054,11377,1634,8719,.8184549,.8882984,.5303963,.0761772,.7678495,.4068532,.2436147,8.949094
7008,92312,7157,12037,53526,65563,31786,13189,6999,40600,16632,7623,8814,3443,624,4803,.6710913,.7322422,.2860347,.0518402,.5938423,.2464036,.1307589,13.25563
8001,98219,8048,14589,53360,67949,34889,14171,6708,46238,17508,7171,11349,3337,463,5228,.6496024,.7779149,.228734,.0317362,.6538419,.2655735,.1257121,24.27994
8002,398115,33350,57531,231278,288809,167413,84499,47542,213981,105667,51857,46568,21168,4315,24878,.745967,.8094419,.3679408,.075003,.7238604,.3653568,.2055621,12.86522
8003,98004,6924,11072,60019,71091,34292,13126,5956,42081,15160,6395,7789,2034,439,4456,.6435586,.7034863,.1837066,.0396496,.5713524,.2186974,.0992352,27.63995
9001,638333,47461,96325,398653,494978,267376,165559,109478,338190,204885,121378,70814,39326,11900,36362,.7661448,.735157,.4082637,.1235401,.6706986,.415296,.2746198,22.17648
10001,151348,16047,39978,75817,115795,57258,37293,22278,93909,62786,26991,36651,25493,4713,13196,.8223344,.9167792,.6376757,.1178898,.7552132,.4918818,.2938391,34.33724
10002,15289,1244,2037,8222,10259,4165,1262,465,5553,1559,481,1388,297,16,689,.5538585,.6813942,.1458026,.0078547,.5065677,.1534906,.0565556,51.2548
10003,97740,7612,13127,56053,69180,36901,16874,7408,46609,19923,7905,9708,3049,497,4735,.6220441,.7395445,.2322694,.0378609,.6583233,.3010365,.1321606,30.74916
10004,20023,1355,2346,12048,14394,6457,2392,916,8084,2789,986,1627,397,70,788,.5815498,.6935209,.1692242,.029838,.5359396,.1985392,.0760292,42.00928
10005,272959,21223,34806,170292,205098,128448,63518,29142,156723,74092,30965,28275,10574,1823,14905,.7023041,.8123599,.3037982,.052376,.7542809,.3729946,.1711296,17.64566
10006,1018200,56301,100623,702820,803443,495118,231569,106390,572002,261334,112429,76884,29765,6039,36245,.6437719,.7640798,.2958071,.0600161,.7044734,.3294855,.1513759,24.05504
10007,9294,597,947,5491,6438,2583,922,381,3211,1096,390,628,174,9,366,.6130653,.6631468,.1837381,.0095037,.4704061,.1679111,.0693863,57.23735
10008,58460,2499,3603,45574,49177,30417,12933,5820,33173,13576,5925,2756,643,105,1506,.602641,.7649181,.1784624,.0291424,.66742,.2837802,.1277044,25.59416
10009,54703,2594,3631,40583,44214,22428,7565,2871,24925,8171,2982,2497,606,111,1690,.6515034,.6876894,.1668962,.0305701,.5526452,.1864081,.0707439,44.91228
10010,67052,5373,6663,37625,44288,27724,13191,6315,32531,14553,6543,4807,1362,228,3751,.6981202,.7214468,.2044124,.0342188,.7368505,.3505914,.1678405,35.83908
10011,85971,5127,8488,57539,66027,40955,20509,10618,46138,21916,10875,5183,1407,257,2469,.4815682,.6106268,.1657634,.030278,.7117781,.3564365,.1845357,30.94886
10012,35399,2666,4306,19917,24223,11722,4878,1848,14924,5939,1960,3202,1061,112,1888,.708177,.7436135,.2464004,.0260102,.5885425,.2449164,.0927851,46.03411
10013,1625781,110810,187701,1048561,1236262,671064,351928,175795,812032,418077,187916,140968,66149,12121,77810,.702193,.7510242,.3524169,.0645761,.6399857,.3356295,.1676536,22.27667
10014,19039,1355,2404,11517,13921,5825,2015,945,7076,2245,1016,1251,230,71,638,.4708487,.5203827,.0956739,.0295341,.5057741,.1749588,.0820526,43.44384
10015,7751,600,780,4675,5455,2311,658,230,2737,690,233,426,32,3,282,.47,.5461538,.0410256,.0038462,.4943315,.1407487,.0491979,48.14815
10016,571003,41812,79225,328707,407932,219484,102163,46071,277859,120588,49439,58375,18425,3368,26032,.6225964,.7368255,.2325655,.0425118,.6677193,.3108026,.1401583,26.2502
10017,233794,19616,35047,131303,166350,88366,40626,18540,115406,51290,20801,27040,10664,2261,12762,.6505914,.7715354,.3042771,.0645134,.672993,.3094065,.1412001,27.53234
10018,10913,632,918,7486,8404,5299,2455,1028,5983,2725,1052,684,270,24,360,.5696203,.7450981,.2941177,.0261438,.7078547,.3279455,.137323,46.23878
10019,7661,601,771,4501,5272,1982,760,407,2397,839,407,415,79,0,312,.5191348,.538262,.1024643,0,.4403466,.1688514,.0904244,58.8943
10020,41565,3346,4839,22658,27497,10672,4010,1956,13594,4808,2163,2922,798,207,2221,.6637776,.6038437,.1649101,.0427774,.4710036,.1769794,.0863271,60.15988
10021,5767,531,684,3337,4021,1887,682,238,2331,790,256,444,108,18,344,.6478343,.6491228,.1578947,.0263158,.565478,.2043752,.0713215,54.48276
10022,5992,366,561,3770,4331,1999,644,295,2397,743,305,398,99,10,181,.4945355,.7094474,.1764706,.0178253,.5302387,.1708223,.0782493,38.72893
10023,10658,743,1207,6182,7389,3625,996,419,4517,1163,439,892,167,20,524,.705249,.7390224,.1383596,.01657,.5863798,.1611129,.0677774,34.70371
10024,8761,641,987,4733,5720,2340,632,281,3029,770,320,689,138,39,403,.6287051,.698075,.1398176,.0395137,.494401,.1335305,.0593704,59.03072
10025,19379,1506,2135,10704,12839,4805,1628,789,5841,1948,830,1036,320,41,760,.5046481,.4852459,.1498829,.0192037,.4488976,.1520927,.0737108,43.96071
10026,18599,1400,2000,10079,12079,5093,1749,769,6277,2103,855,1184,354,86,883,.6307143,.592,.177,.043,.5053081,.1735291,.0762973,35.62414
10027,44469,2441,3349,31629,34978,18953,6999,2719,21208,7675,2805,2255,676,86,1610,.6595657,.6733353,.2018513,.0256793,.5992286,.2212843,.0859654,43.96844
10028,47526,2766,4293,32760,37053,18737,7517,3183,21515,8327,3348,2778,810,165,1683,.6084599,.6470999,.1886792,.0384347,.5719475,.2294566,.0971612,35.32071
10029,646960,48743,87448,384098,471546,252920,118349,55610,318648,145698,60375,65728,27349,4765,31882,.6540837,.7516238,.3127459,.0544895,.6584778,.3081219,.1447808,27.95543
10030,14723,1049,1485,8855,10340,3873,1164,528,4794,1393,548,921,229,20,636,.6062917,.620202,.1542087,.013468,.43738,.1314512,.0596273,62.14177
10031,59896,3691,6010,40054,46064,26694,13158,6207,30684,14446,6411,3990,1288,204,1981,.5367109,.6638935,.2143095,.0339434,.6664503,.3285065,.1549658,30.57062
10032,39154,3365,5103,22492,27595,11496,4271,1833,14408,5112,1967,2912,841,134,2255,.6701337,.5706447,.164805,.0262591,.5111151,.1898897,.0814956,52.51459
10033,10703,819,1186,5985,7171,3096,1292,678,3949,1462,697,853,170,19,590,.7203907,.7192243,.1433389,.0160202,.5172932,.215873,.1132832,59.98593
10034,4035,287,396,2307,2703,1244,468,195,1500,525,202,256,57,7,208,.7247387,.6464646,.1439394,.0176768,.5392284,.2028609,.0845254,39.09521
10035,104870,6528,8822,72134,80956,44602,19401,9122,50297,21243,9389,5695,1842,267,4257,.652114,.6455452,.2087962,.0302652,.6183215,.2689578,.1264591,38.40597
10036,205266,11415,19062,141303,160365,95180,42020,18792,108454,45910,19551,13274,3890,759,6513,.570565,.6963593,.2040709,.0398174,.673588,.2973751,.1329908,30.45621
10037,148655,14238,33616,77259,110875,60873,39607,24756,91122,59820,28265,30249,20213,3509,11467,.80538,.8998393,.6012911,.1043848,.7879082,.5126522,.3204287,31.72982
10038,19870,1286,1875,12391,14266,6671,2341,964,7956,2602,1005,1285,261,41,832,.6469674,.6853333,.1392,.0218667,.5383746,.1889274,.0777984,52.0874
10039,4260,284,510,2477,2987,1181,352,199,1556,442,225,375,90,26,150,.528169,.7352941,.1764706,.0509804,.4767864,.1421074,.0803391,48.86935
10040,14894,1206,1650,8359,10009,3637,1470,691,4781,1754,735,1144,284,44,808,.6699834,.6933333,.1721212,.0266667,.4350999,.1758584,.0826654,58.90479
10041,148442,7726,13116,104102,117218,69278,29664,12932,78388,32538,13501,9110,2874,569,4782,.618949,.6945715,.2191217,.0433821,.6654819,.2849513,.1242243,32.10122
10042,122488,8119,11618,78617,90235,46745,18205,7519,54627,20844,7900,7882,2639,381,5198,.6402266,.67843,.2271475,.0327939,.5945915,.2315657,.0956409,44.03659
10043,64014,3761,6175,44478,50653,31304,15080,7096,35961,16850,7346,4657,1770,250,2393,.6362669,.7541701,.2866397,.0404858,.7038086,.339044,.1595396,28.2779
10044,63188,3452,7770,43005,50775,31094,15405,6855,36998,17122,7146,5904,1717,291,1725,.4997103,.7598456,.2209781,.0374517,.7230322,.3582142,.1594001,24.95976
10045,32894,2509,3732,18280,22012,10626,3740,1665,13345,4398,1760,2719,658,95,1646,.6560383,.7285638,.176313,.0254555,.581291,.2045952,.0910832,37.41864
10046,109920,9649,17627,59323,76950,45932,21386,9836,60153,25528,10480,14221,4142,644,6182,.6406882,.8067737,.2349804,.0365349,.7742697,.360501,.1658042,22.28835
10047,20264,1568,2036,11588,13624,5862,1816,666,7093,2024,697,1231,208,31,865,.5516582,.6046169,.1021611,.0152259,.5058681,.1567138,.0574732,31.40006
10048,471016,40186,72196,273811,346007,192794,93290,43062,247542,113261,46443,54748,19971,3381,22872,.5691534,.7583246,.276622,.0468308,.7041134,.3407095,.1572691,23.01893
10049,49287,3444,5558,31058,36616,19080,7342,2843,22863,8248,2996,3783,906,153,1844,.5354239,.6806405,.1630083,.0275279,.6143345,.2363964,.0915384,39.61162
10050,576863,32646,55777,397157,452934,280793,139836,67903,321563,155601,71294,40770,15765,3391,20358,.6235986,.7309464,.2826434,.0607957,.7070075,.3520925,.1709727,27.65751
10051,193643,9331,14121,143523,157644,80091,27162,9804,89412,30067,10192,9321,2905,388,5616,.6018648,.6600807,.205722,.0274768,.558036,.1892519,.0683096,39.68065
10052,728531,38419,65112,524492,589604,358353,169245,76706,406363,187602,79981,48010,18357,3275,25433,.6619902,.7373449,.2819296,.0502979,.6832383,.3226837,.1462482,24.54194
10053,321652,23406,38479,195301,233780,116766,49642,22298,142733,58467,23561,25967,8825,1263,14541,.621251,.6748356,.2293459,.0328231,.5978771,.254182,.1141725,31.15786
10054,50549,3415,5092,31053,36145,17175,6404,2505,20546,7409,2602,3371,1005,97,2146,.6284041,.6620188,.1973684,.0190495,.5530866,.2062281,.0806685,41.74154
10055,51303,3761,6108,31827,37935,20997,9770,4584,24885,11347,4860,3888,1577,276,2415,.6421165,.6365423,.258186,.0451866,.6597229,.3069721,.1440286,37.13752
10056,87182,5470,9412,54887,64299,34406,14521,5979,40284,16487,6220,5878,1966,241,3185,.5822669,.6245219,.2088823,.0256056,.6268516,.2645617,.1089329,32.32462
10057,55988,4459,7837,30843,38680,21446,9439,4451,27659,11629,5095,6213,2190,644,3233,.7250504,.7927778,.2794437,.0821743,.6953279,.3060338,.1443115,30.51543
10058,202251,9969,16715,150154,166869,110187,55002,26637,122951,59470,27470,12764,4468,833,6308,.6327615,.7636255,.2673048,.0498355,.7338266,.3663039,.1773979,23.5596
10059,179752,12839,19099,108072,127171,82349,43339,21116,97067,49414,22349,14718,6075,1233,9217,.7178908,.7706162,.3180795,.0645584,.7619827,.4010197,.1953883,33.42122
10060,24272,1878,3110,14818,17928,7598,2300,1031,9652,2717,1072,2054,417,41,1033,.5500532,.6604502,.1340836,.0131833,.5127547,.1552166,.0695775,52.28672
10061,22287,1614,2221,13109,15330,6989,2248,855,8508,2545,915,1519,297,60,972,.6022305,.6839262,.1337235,.0270149,.5331452,.1714852,.0652224,51.76114
10062,16532,1108,1834,9608,11442,5051,1782,823,6292,2100,904,1241,318,81,779,.7030686,.676663,.1733915,.0441658,.5257077,.1854704,.0856578,43.6123
10063,10166,723,1634,6371,8005,3627,1538,373,4360,1660,375,733,122,2,315,.4356847,.4485924,.0746634,.001224,.5692984,.2414064,.0585465,42.27534
10064,258762,16944,29649,173814,203463,115666,51988,22532,139080,62045,23689,23414,10057,1157,11425,.67428,.7897062,.339202,.0390232,.6654585,.2991014,.1296328,29.91577
10065,10887,748,1102,6268,7370,3551,1113,529,4339,1203,534,788,90,5,478,.6390374,.7150635,.0816697,.0045372,.5665284,.1775686,.0843969,60.23081
10066,21300,1420,2117,13442,15559,6826,2737,1290,8285,3086,1362,1459,349,72,939,.6612676,.6891828,.1648559,.0340104,.5078113,.2036155,.0959679,51.25796
10067,14509,968,1372,8827,10199,4506,1350,552,5351,1532,559,845,182,7,646,.6673554,.6158892,.1326531,.005102,.5104792,.1529398,.0625354,58.23049
11001,15565,1183,1812,8386,10198,3485,1181,544,4756,1377,594,1271,196,50,695,.5874894,.7014349,.1081678,.0275938,.4155736,.14083,.06487,61.66511
11002,6141,550,713,3325,4038,1168,354,166,1593,446,175,425,92,9,372,.6763636,.5960729,.1290323,.0126227,.3512782,.1064662,.0499248,68.26228
11003,9379,682,959,5186,6145,2163,628,356,2873,734,370,710,106,14,393,.5762463,.7403545,.1105318,.0145985,.4170845,.1210953,.0686464,58.15068
11004,3808,279,469,2061,2530,597,209,101,884,242,101,287,33,0,186,.6666667,.6119403,.0703625,0,.2896652,.1014071,.0490053,74.05536
11005,34686,3534,5773,19248,25021,10172,5143,2960,14022,6806,3298,3850,1663,338,2105,.5956423,.6668977,.2880651,.0585484,.5284705,.2671966,.1537822,40.46675
11006,8702,533,969,5133,6102,2028,567,256,2570,669,276,542,102,20,246,.4615385,.5593395,.1052632,.0206398,.3950906,.1104617,.0498734,43.5506
11007,21354,1517,2449,12289,14738,4633,1950,921,6024,2295,1005,1391,345,84,770,.5075808,.5679869,.1408738,.0342997,.3770038,.1586785,.0749451,40.52525
11008,40760,2730,4492,23298,27790,9289,3341,1468,11864,3897,1568,2575,556,100,1394,.5106227,.5732413,.1237756,.0222618,.3987038,.1434029,.0630097,40.35842
11009,16000,1014,1775,9361,11136,4039,1677,754,5048,1937,809,1009,260,55,540,.5325444,.5684507,.1464789,.0309859,.431471,.1791475,.080547,50.52298
11010,13525,1024,1565,7786,9351,3201,1027,457,4046,1200,500,845,173,43,621,.6064453,.5399361,.1105431,.027476,.4111225,.1319034,.0586951,55.39621
11011,150256,11241,19573,86567,106140,48292,21947,11273,62266,27100,12324,13974,5153,1051,8123,.7226225,.7139426,.2632708,.0536964,.5578569,.2535262,.1302228,31.8585
11012,10767,1235,1684,5932,7616,2787,1176,532,4131,1663,595,1344,487,63,1041,.842915,.7980998,.2891924,.0374109,.4698247,.1982468,.0896831,48.47461
11013,8701,635,971,4726,5697,2264,526,226,2919,624,228,655,98,2,385,.6062992,.6745623,.1009269,.0020597,.4790521,.1112992,.0478206,51.87983
11014,15255,1158,1664,8457,10121,3341,1266,638,4515,1483,681,1174,217,43,716,.6183074,.7055289,.1304087,.0258413,.3950574,.1496985,.0754405,64.91758
11015,10175,856,1214,5422,6636,2271,629,237,2974,749,269,703,120,32,449,.5245327,.5790774,.0988468,.0263591,.4188491,.1160089,.0437108,59.32549
11016,35785,4217,8084,17819,25903,9250,4919,2788,16258,8715,3155,7008,3796,367,3334,.7906094,.8668976,.4695695,.0453983,.5191088,.2760536,.1564622,53.25795
11017,19349,1567,2360,10191,12551,3929,1702,800,5272,2012,892,1343,310,92,996,.6356094,.5690678,.1313559,.0389831,.3855363,.1670101,.0785006,70.03029
11018,13665,1135,2003,7614,9617,3319,1091,487,4537,1302,519,1218,211,32,629,.554185,.6080879,.105342,.015976,.4359075,.1432887,.0639611,58.1553
11019,5717,503,696,3152,3848,1095,509,226,1565,650,240,470,141,14,364,.723658,.6752874,.2025862,.0201149,.3473985,.1614848,.0717005,73.48635
11020,13371,1060,1799,7062,8861,3637,1388,577,4914,1664,600,1277,276,23,694,.654717,.7098388,.1534186,.0127849,.5150099,.1965449,.0817049,34.3996
11021,7518,500,740,4521,5261,1841,846,409,2244,948,427,403,102,18,304,.608,.5445946,.1378378,.0243243,.4072108,.1871267,.0904667,61.44472
11022,56346,4927,8480,30973,39453,14521,6376,3471,20664,8986,3800,6143,2610,329,3389,.6878425,.7244104,.307783,.0387972,.4688277,.2058567,.1120653,38.8708
11023,36991,2629,4177,21414,25591,11930,4125,1554,14632,4858,1631,2702,733,77,1580,.600989,.6468757,.1754848,.0184343,.5571122,.192631,.0725693,25.59837
11024,7343,582,842,3802,4644,1656,490,210,2169,528,214,513,38,4,354,.6082474,.6092637,.0451306,.0047506,.4355602,.1288795,.0552341,47.57814
11025,202226,15374,27586,114459,142045,69327,33297,16173,88619,39792,17554,19292,6495,1381,10126,.6586444,.6993402,.2354455,.0500616,.6056929,.2909077,.1412995,31.08258
11026,21732,4307,8860,7137,15997,5841,2786,1456,11787,3776,1741,5946,990,285,420,.0975157,.6711061,.1117381,.032167,.8184111,.3903601,.2040073,22.37376
11027,21856,1403,2255,13132,15387,4506,1663,770,5756,1869,822,1250,206,52,675,.4811119,.5543237,.0913526,.0230599,.3431313,.1266372,.0586354,36.79816
11028,51699,3301,5648,29178,34826,15198,6430,2828,18731,7326,3042,3533,896,214,1859,.5631627,.6255311,.1586402,.0378895,.5208719,.2203715,.0969223,39.9903
11029,74498,8158,22377,35790,58167,24136,16974,12523,44407,32120,15367,20271,15146,2844,7031,.8618534,.9058855,.6768557,.1270948,.6743783,.4742666,.3499022,35.01804
11030,3553,248,378,2071,2449,771,361,202,968,395,216,197,34,14,133,.5362903,.521164,.0899471,.037037,.3722839,.1743119,.0975374,64.9025
11031,150357,11426,19864,81077,100941,53925,21293,8382,68144,25480,9143,14219,4187,761,6967,.6097497,.7158176,.2107833,.0383105,.6651085,.2626269,.1033832,18.5548
11032,6660,514,795,3551,4346,1220,445,231,1672,543,261,452,98,30,273,.5311284,.5685534,.1232704,.0377358,.3435652,.1253168,.0650521,63.71553
11033,297718,20632,36683,174075,210758,125848,72428,39990,154329,84513,43040,28481,12085,3050,13834,.6705118,.7764087,.3294442,.0831448,.7229527,.4160735,.2297286,16.95365
11034,26894,2228,3660,14532,18192,6301,2881,1190,8702,3602,1283,2401,721,93,1426,.6400359,.6560109,.1969945,.0254098,.4335948,.1982521,.0818882,55.13801
11035,35376,2617,3743,20220,23963,9119,3693,1690,11487,4302,1785,2368,609,95,1756,.6709973,.6326476,.1627037,.0253807,.4509891,.182641,.0835806,47.43382
11036,40118,3102,4768,21862,26630,14701,6972,3362,17927,7892,3559,3226,920,197,2133,.6876209,.676594,.192953,.0413171,.6724454,.3189095,.1537828,46.55434
11037,13490,1058,1384,7556,8940,2927,985,427,3814,1186,446,887,201,19,652,.6162571,.640896,.1452312,.0137283,.3873743,.13036,.0565114,54.27484
11038,39268,2837,4100,22744,26844,10493,4455,2237,13272,5111,2424,2779,656,187,1751,.6172013,.6778049,.16,.0456098,.4613524,.1958758,.0983556,44.84414
11039,7684,611,945,4180,5125,1694,504,272,2310,624,312,616,120,40,382,.6252046,.6518518,.1269841,.042328,.4052632,.1205742,.0650718,64.60905
11040,19489,1534,2214,10807,13021,4874,2079,970,6133,2401,1032,1259,322,62,885,.5769231,.568654,.1454381,.0280036,.451004,.1923753,.0897566,55.86949
11041,12318,1006,1686,6814,8500,2980,1135,532,4113,1481,575,1133,346,43,657,.6530815,.6720048,.2052194,.0255042,.4373349,.1665688,.0780746,45.31809
11042,4774,365,477,2826,3303,1036,312,125,1280,369,152,244,57,27,213,.5835617,.5115304,.1194969,.0566038,.3665959,.1104034,.0442321,62.1311
11043,25495,1983,2953,13930,16883,6330,2481,1164,7999,2965,1245,1669,484,81,1347,.6792738,.5651879,.1639011,.0274297,.4544149,.1781048,.0835607,53.10465
11044,483024,36686,66844,281440,348284,216405,137075,78569,271181,166053,86541,54776,28978,7972,28225,.769367,.8194602,.4335169,.1192628,.7689205,.4870487,.2791679,14.10751
11045,16955,1296,1735,9850,11585,3958,1569,647,5107,1845,692,1149,276,45,854,.6589506,.6622478,.1590778,.0259366,.4018274,.1592893,.0656853,50.90573
11046,10826,852,1260,5953,7213,2020,1039,473,2719,1232,517,699,193,44,603,.7077465,.5547619,.1531746,.0349206,.3393247,.1745338,.0794557,65.4229
11047,100718,8722,14249,52118,66367,30465,14857,7411,40168,18320,7969,9703,3463,558,5715,.6552396,.6809601,.2430346,.0391606,.5845389,.2850647,.1421966,36.34142
11048,54573,3896,5750,29909,35659,17155,6202,2712,20990,7076,2900,3835,874,188,2035,.5223306,.6669565,.152,.0326957,.5735732,.2073623,.090675,37.2528
11049,13158,1007,1382,7176,8558,2783,1131,614,3525,1347,651,742,216,37,715,.7100298,.536903,.1562952,.0267728,.3878205,.1576087,.085563,71.5274
11050,2297,181,276,1231,1507,505,119,48,662,142,59,157,23,11,107,.5911602,.5688406,.0833333,.0398551,.4102356,.0966694,.0389927,60.37167
11051,18327,1462,2025,9979,12004,4651,1283,517,5855,1470,555,1204,187,38,865,.5916553,.5945679,.0923457,.0187654,.4660788,.12857,.0518088,43.85122
11052,18758,1366,2102,11068,13170,4586,1668,875,5914,2003,958,1328,335,83,875,.6405564,.6317793,.159372,.0394862,.4143477,.1507047,.0790567,46.7635
11053,20795,1502,2259,11715,13974,4503,1757,848,5747,2082,890,1244,325,42,913,.6078562,.5506861,.143869,.0185923,.384379,.1499787,.0723858,54.64649
11054,8428,682,990,4635,5625,1997,752,334,2683,912,379,686,160,45,461,.6759531,.6929293,.1616162,.0454545,.4308522,.1622438,.0720604,56.28926
11055,14748,838,1261,9494,10755,3886,1230,496,4699,1372,535,813,142,39,516,.6157518,.6447264,.112609,.0309278,.4093111,.1295555,.0522435,47.66743
11056,29043,2046,2417,16950,19367,12426,6122,2796,14192,6708,2932,1766,586,136,1610,.7869013,.7306578,.2424493,.0562681,.7330974,.3611799,.1649558,43.84662
11057,79800,5981,10074,47494,57568,23165,10171,5592,30169,12874,6076,7004,2703,484,4002,.6691189,.6952551,.2683145,.0480445,.4877458,.2141534,.1177412,29.44163
11058,27958,1932,3136,15947,19083,8099,3185,1388,10146,3722,1529,2047,537,141,1123,.5812629,.6527423,.1712372,.0449617,.5078698,.1997241,.0870383,41.6585
11059,15185,1125,1752,9139,10891,3467,1540,719,4573,1938,784,1106,398,65,708,.6293333,.6312785,.2271689,.0371005,.3793632,.1685086,.0786738,48.02406
11060,589904,42107,82485,348083,430568,229744,137606,79927,293349,169864,87683,63605,32258,7756,30425,.7225639,.7711099,.3910772,.0940292,.6600265,.3953252,.2296205,29.11679
11061,11110,738,1203,6743,7946,2527,929,444,3132,1091,473,605,162,29,382,.5176152,.5029094,.1346633,.0241064,.374759,.1377725,.0658461,58.40959
11062,2382,150,273,1470,1743,468,151,70,617,160,70,149,9,0,76,.5066667,.5457876,.032967,0,.3183673,.1027211,.047619,61.57254
11063,54981,4358,6588,32188,38776,19914,9652,4785,24222,10889,5076,4308,1237,291,2619,.6009638,.6539162,.1877656,.0441712,.6186778,.2998633,.1486579,31.53548
11064,30070,2182,3299,17239,20538,7264,2591,1175,9238,3016,1231,1974,425,56,1240,.568286,.5983632,.1288269,.0169748,.4213701,.1502987,.0681594,42.83241
11065,19845,1525,2164,11184,13348,4547,1720,783,5735,2001,866,1188,281,83,837,.5488524,.5489833,.1298521,.0383549,.406563,.1537911,.0700107,57.50694
11066,11391,801,1271,6414,7685,2237,840,405,2962,997,453,725,157,48,504,.6292135,.570417,.1235248,.0377655,.3487683,.1309635,.0631431,58.15844
11067,166903,10601,17726,95185,112911,68294,36943,17984,81683,41823,19194,13389,4880,1210,7111,.6707858,.7553312,.2753018,.0682613,.717487,.3881179,.1889373,31.71692
11068,25020,2464,4144,14105,18249,6133,2666,1312,8429,3288,1400,2296,622,88,1228,.4983766,.5540541,.1500965,.0212355,.4348103,.189011,.0930167,40.6317
11069,75649,5525,9064,44237,53301,21295,10469,5377,27187,12490,5787,5892,2021,410,3172,.5741177,.6500441,.22297,.0452339,.4813844,.2366571,.1215498,37.60048
11070,9466,788,1088,5001,6089,1678,628,320,2351,808,343,673,180,23,599,.7601523,.6185662,.1654412,.0211397,.3355329,.1255749,.0639872,72.45093
11071,18422,1313,1931,11003,12934,4623,1735,758,5871,2025,764,1248,290,6,838,.6382331,.6462973,.1501812,.0031072,.4201581,.1576843,.0688903,39.62173
11072,15464,1176,1534,9372,10906,4658,2344,1108,5551,2607,1156,893,263,48,775,.6590136,.5821382,.1714472,.0312907,.4970124,.2501067,.1182245,54.99448
11073,18585,1269,1969,10933,12902,4167,1740,838,5375,1983,897,1208,243,59,790,.6225374,.6135094,.1234129,.0299644,.3811397,.1591512,.0766487,47.48252
11074,6520,449,728,3762,4490,1336,487,164,1770,586,175,434,99,11,210,.467706,.5961539,.135989,.0151099,.3551303,.1294524,.0435938,54.85247
11075,36309,2660,3964,20964,24928,11405,4469,1981,14001,5233,2175,2596,764,194,1639,.6161654,.6548941,.1927346,.0489405,.5440279,.213175,.0944953,46.21779
11076,77605,6809,10783,41683,52466,28696,12021,5517,36572,14009,5863,7876,1988,346,4547,.6677926,.730409,.1843643,.0320875,.6884341,.288391,.1323561,26.81287
11077,8988,722,853,5201,6054,2056,749,296,2664,968,316,608,219,20,489,.6772853,.7127784,.2567409,.0234467,.3953086,.1440108,.0569121,66.86858
11078,25343,1840,2905,14693,17598,5976,2265,1169,7602,2772,1275,1626,507,106,1070,.5815217,.5597246,.1745267,.0364888,.4067243,.154155,.0795617,41.32634
11079,7553,585,800,4411,5211,1828,757,406,2373,872,442,545,115,36,377,.6444445,.68125,.14375,.045,.4144185,.1716164,.0920426,66.41353
11080,11473,870,1289,6347,7636,2572,907,471,3378,1108,497,806,201,26,477,.5482759,.6252909,.1559348,.0201707,.4052308,.1429022,.0742083,52.78414
11081,18403,1422,2085,10183,12268,3710,1508,696,5059,1713,736,1349,205,40,916,.6441631,.6470024,.0983213,.0191847,.3643327,.14809,.0683492,66.04118
11082,8841,768,1045,4912,5957,1729,777,343,2300,895,366,571,118,23,502,.6536458,.5464115,.1129187,.0220096,.3519951,.158184,.069829,58.32802
11083,8660,570,975,4974,5949,1742,582,307,2334,659,317,592,77,10,352,.6175439,.6071795,.0789744,.0102564,.3502212,.1170084,.0617209,49.60602
11084,16579,1324,1931,9365,11296,5079,1958,989,6503,2303,1019,1424,345,30,875,.6608762,.7374417,.1786639,.015536,.5423385,.2090763,.105606,50.09805
11085,12215,1156,1439,7055,8494,3221,1307,565,4222,1557,571,1001,250,6,824,.7128028,.695622,.1737318,.0041696,.4565556,.1852587,.080085,42.96898
11086,5654,476,660,3029,3689,1193,462,160,1554,543,166,361,81,6,301,.6323529,.5469697,.1227273,.0090909,.3938594,.1525256,.0528227,60.91278
11087,36990,2870,4083,21391,25474,9779,4166,2098,12205,4666,2210,2426,500,112,1815,.6324042,.5941709,.122459,.0274308,.4571549,.1947548,.0980786,52.10479
11088,11684,889,1492,6213,7705,3363,1464,578,4417,1715,645,1054,251,67,594,.6681665,.7064343,.1682306,.0449062,.5412844,.235635,.0930307,60.76637
11089,37583,4575,11833,14581,26414,10121,3980,1800,18914,5344,2141,8793,1364,341,1229,.2686339,.7430913,.1152709,.0288177,.6941225,.272958,.1234483,51.1956
11090,6716,535,794,3873,4667,1591,557,281,2148,657,301,557,100,20,340,.635514,.7015113,.1259446,.0251889,.4107927,.1438162,.0725536,66.88519
11091,4524,443,721,2284,3005,1054,301,145,1600,403,162,546,102,17,246,.5553048,.7572815,.1414702,.0235784,.4614711,.1317863,.0634851,62.35183
11092,67972,5847,11139,35508,46647,20264,9319,4671,28639,12934,5148,8375,3615,477,3983,.681204,.7518628,.3245354,.0428225,.5706883,.2624479,.1315478,40.91101
11093,10762,1252,2120,5703,7823,2461,1043,561,4159,1937,626,1698,894,65,912,.7284345,.8009434,.4216981,.0306604,.4315273,.1828862,.0983693,50.50414
11094,18546,1529,2202,10421,12623,4364,1629,859,5711,2069,916,1347,440,57,830,.5428385,.6117166,.1998183,.0258856,.4187698,.156319,.0824297,52.50098
11095,8046,702,954,4333,5287,1793,598,262,2325,683,273,532,85,11,446,.6353276,.557652,.0890985,.0115304,.4138011,.1380106,.0604662,66.33758
11096,14003,1093,1647,7581,9228,2670,1251,604,3669,1557,697,999,306,93,709,.6486734,.6065574,.1857924,.0564663,.3521963,.1650178,.0796729,64.37058
11097,17747,1216,1980,10250,12230,4370,1651,768,5627,1944,823,1257,293,55,767,.6307566,.6348485,.1479798,.0277778,.4263415,.1610732,.0749268,54.89691
11098,5297,437,609,2910,3519,1048,385,178,1461,436,182,413,51,4,265,.6064073,.6781609,.0837438,.0065681,.3601375,.1323024,.0611684,69.71467
11099,21229,1606,2415,11872,14287,4681,1715,843,6022,1913,909,1341,198,66,915,.5697385,.5552795,.0819876,.0273292,.3942891,.1444575,.0710074,56.30407
11100,7038,532,774,4000,4774,1664,712,284,2086,801,307,422,89,23,391,.7349624,.5452197,.1149871,.0297158,.416,.178,.071,62.96948
11101,21114,1806,2414,11130,13544,4390,1840,830,5700,2158,897,1310,318,67,1201,.6650056,.5426677,.1317316,.0277548,.3944295,.165319,.0745732,55.26159
11102,14610,1150,1843,8461,10304,3849,1459,795,5185,1976,872,1336,517,77,877,.7626087,.7249051,.2805209,.0417797,.4549108,.1724382,.0939605,50.58392
11103,7011,635,1199,3736,4935,1566,514,266,2322,772,287,756,258,21,430,.6771653,.6305254,.2151793,.0175146,.4191649,.1375803,.0711991,63.67847
11104,11572,953,1308,6414,7722,2634,1229,615,3357,1447,649,723,218,34,617,.6474292,.5527523,.1666667,.0259939,.4106642,.1916121,.095884,54.1145
11105,19685,1507,2446,10690,13136,3866,1236,545,5106,1463,594,1240,227,49,636,.4220305,.5069501,.0928046,.0200327,.3616464,.1156221,.0509822,44.9267
11106,170108,15189,26050,93795,119845,57097,26533,12088,74864,32615,13350,17767,6082,1262,8229,.5417737,.6820346,.2334741,.0484453,.6087425,.2828829,.1288768,30.34513
11107,34489,2972,4190,19088,23278,8608,3366,1651,11366,4151,1791,2758,785,140,1968,.6621804,.6582339,.1873508,.0334129,.4509639,.1763412,.0864941,40.1711
11108,12427,860,1553,7088,8641,4259,2396,1500,5314,2962,1619,1055,566,119,564,.6558139,.6793303,.3644559,.0766259,.6008747,.3380361,.2116253,45.44531
11109,8929,638,1052,5109,6161,2177,843,484,2866,955,502,689,112,18,389,.6097178,.654943,.1064639,.0171103,.4261108,.1650029,.0947348,58.75778
11110,26110,1849,3027,14619,17646,6090,1710,628,7943,2187,722,1853,477,94,1027,.5554354,.6121572,.1575818,.0310538,.4165812,.1169711,.0429578,35.86393
11111,19151,1787,2901,10067,12968,5136,2624,1445,7161,3575,1574,2025,951,129,1309,.7325126,.6980352,.327818,.0444674,.5101818,.2606536,.1435383,47.6771
11112,11652,872,1333,7033,8366,2665,1074,483,3311,1178,510,646,104,27,415,.4759174,.4846212,.0780195,.0202551,.3789279,.1527087,.0686762,48.79588
11113,11897,836,1285,6667,7952,3102,1065,457,3992,1200,497,890,135,40,445,.5322967,.692607,.1050584,.0311284,.4652767,.159742,.0685466,54.55408
11114,8937,692,953,5220,6173,2449,946,454,3044,1104,479,595,158,25,433,.6257225,.6243442,.1657922,.0262329,.4691571,.1812261,.0869732,54.49401
11115,32386,2344,3699,19152,22851,7609,2576,1091,9968,3076,1181,2359,500,90,1281,.5465017,.63774,.1351717,.0243309,.3972953,.1345029,.0569653,39.99345
11116,8950,646,1010,5187,6197,2376,1104,445,3048,1280,465,672,176,20,425,.6578947,.6653466,.1742574,.019802,.4580683,.2128398,.0857914,43.84823
11117,10295,768,1185,5995,7180,2777,1098,552,3526,1254,570,749,156,18,449,.5846354,.6320675,.1316456,.0151899,.4632193,.1831526,.0920767,57.1544
11118,2357,173,265,1342,1607,481,187,88,609,214,88,128,27,0,111,.6416185,.4830189,.1018868,0,.3584203,.1393443,.0655738,73.07548
11119,10466,639,1063,6641,7704,3072,1454,759,3791,1639,801,719,185,42,389,.6087637,.6763876,.1740357,.0395108,.4625809,.2189429,.11429,49.55429
11120,9599,886,1227,5363,6590,1910,838,357,2803,1068,399,893,230,42,584,.6591422,.7277914,.1874491,.0342298,.356144,.1562558,.0665672,65.73708
11121,181629,17411,31841,97580,129421,59884,28610,14469,82473,35522,16386,22589,6912,1917,8087,.4644765,.7094312,.2170786,.0602054,.6136913,.2931953,.1482783,37.12339
11122,36747,2613,3730,20774,24504,13180,5760,2618,15668,6554,2806,2488,794,188,1835,.7022579,.6670241,.2128686,.0504021,.6344469,.2772697,.1260229,40.14885
11123,3433,276,352,1874,2226,831,325,157,1072,428,192,241,103,35,196,.7101449,.6846591,.2926136,.0994318,.4434365,.1734258,.083778,71.00592
11124,14043,1110,1646,7999,9645,3321,1307,592,4395,1594,631,1074,287,39,732,.6594595,.6524909,.1743621,.0236938,.4151769,.1633954,.0740093,61.17557
11125,9057,773,915,5152,6067,2209,851,374,2781,1032,431,572,181,57,550,.7115136,.6251366,.1978142,.0622951,.4287655,.1651786,.0725932,62.7274
11126,47899,3461,5316,27425,32741,12181,5117,2475,14950,5942,2639,2769,825,164,2287,.6607917,.5208803,.1551919,.0308503,.4441568,.1865816,.0902461,34.07647
11127,21763,1472,2587,12968,15555,5614,2579,1280,7333,3280,1408,1719,701,128,924,.6277174,.6644762,.2709702,.0494782,.4329118,.1988741,.0987045,39.88405
11128,5896,554,615,3272,3887,1174,514,252,1558,599,257,384,85,5,407,.734657,.6243902,.1382114,.0081301,.358802,.1570905,.0770171,68.898
11129,29360,2542,4368,15836,20204,7426,4026,2215,10571,5300,2332,3145,1274,117,1869,.7352479,.7200091,.2916667,.0267857,.4689316,.2542309,.1398712,55.16456
11130,6536,536,756,3695,4451,1489,531,295,1974,588,321,485,57,26,375,.6996269,.6415344,.0753968,.0343915,.402977,.1437077,.0798376,67.09367
11131,2032,130,192,1268,1460,318,136,69,398,155,74,80,19,5,83,.6384615,.4166667,.0989583,.0260417,.2507886,.1072555,.0544164,67.03959
11132,18134,1280,2118,10893,13011,4834,1659,563,6152,1984,615,1318,325,52,759,.5929688,.6222852,.1534466,.0245515,.4437712,.1522996,.0516846,56.21688
11133,7902,708,967,4476,5443,1612,646,329,2187,797,354,575,151,25,495,.6991525,.5946226,.1561531,.0258532,.360143,.1443253,.0735031,64.34201
11134,11445,853,1225,6679,7904,2644,1125,540,3391,1285,556,747,160,16,552,.6471278,.6097959,.1306122,.0130612,.3958676,.1684384,.0808504,61.86502
11135,12017,1091,1458,6529,7987,2433,1170,586,3218,1405,601,785,235,15,700,.6416132,.5384088,.1611797,.0102881,.3726451,.1792005,.0897534,66.79115
11136,38098,3176,4472,21579,26051,10498,4608,2411,13399,5164,2554,2901,556,143,1888,.5944585,.648703,.1243292,.0319767,.4864915,.2135409,.111729,47.24321
11137,32862,3142,4933,17488,22421,7957,3954,2017,11288,5210,2156,3331,1256,139,2318,.7377467,.6752483,.2546118,.0281776,.4549977,.2260979,.1153362,52.83723
11138,22592,1708,2514,12577,15091,5535,2411,1163,7177,2785,1242,1642,374,79,1151,.6738876,.6531424,.1487669,.031424,.440089,.1916991,.0924704,51.81549
11139,5638,660,859,3494,4353,1574,680,346,2298,887,357,724,207,11,556,.8424242,.8428405,.2409779,.0128056,.4504865,.1946193,.0990269,55.80585
11140,6087,455,613,3436,4049,1134,431,214,1462,512,214,328,81,0,249,.5472528,.5350734,.132137,0,.3300349,.1254366,.0622817,63.66039
11141,50003,3274,5978,29186,35164,12201,5528,3181,15856,6805,3486,3655,1277,305,2017,.616066,.6114085,.2136166,.0510204,.4180429,.1894059,.1089906,40.5028
11142,9510,675,1048,5180,6228,2063,844,406,2666,983,426,603,139,20,370,.5481482,.5753817,.1326336,.019084,.3982626,.1629344,.0783784,60.27165
11143,9354,784,1251,4932,6183,1656,509,251,2468,659,266,812,150,15,489,.6237245,.6490808,.1199041,.0119904,.3357664,.1032036,.0508921,54.52171
11144,9390,667,974,5779,6753,2233,1027,462,2796,1128,467,563,101,5,376,.5637181,.5780287,.1036961,.0051335,.386399,.1777124,.0799446,63.57719
11145,25998,1944,2802,15826,18628,6562,2499,1119,8019,2901,1183,1457,402,64,1224,.6296296,.5199857,.1434689,.0228408,.4146341,.1579047,.0707064,33.21918
11146,56470,3828,6215,33427,39642,14922,4920,2011,18792,5841,2194,3870,921,183,2180,.569488,.622687,.1481899,.0294449,.4464056,.1471864,.0601609,30.48208
11147,31211,2308,3410,17482,20892,6646,2522,1284,8515,2865,1343,1869,343,59,1265,.5480936,.5480939,.1005865,.0173021,.3801624,.1442627,.073447,44.09373
11148,37180,2716,4042,21372,25414,10087,4379,2137,12646,5035,2238,2559,656,101,1771,.6520619,.6331024,.1622959,.0249876,.4719727,.2048943,.0999906,37.17169
11149,6583,540,704,3762,4466,1174,431,284,1512,493,291,338,62,7,302,.5592592,.4801136,.0880682,.0099432,.312068,.1145667,.0754918,68.57795
11150,18842,1599,2261,10436,12697,3954,1488,911,5393,1771,945,1439,283,34,1062,.6641651,.636444,.1251658,.0150376,.3788808,.1425834,.087294,61.69934
11151,20750,1586,2395,11739,14134,5711,2099,840,7302,2473,912,1591,374,72,1086,.6847415,.6643006,.1561587,.0300626,.486498,.1788057,.0715564,48.75289
11152,2341,139,250,1306,1556,477,185,88,641,218,95,164,33,7,102,.7338129,.656,.132,.028,.3652374,.1416539,.0673813,75.14952
11153,5155,361,461,2963,3424,1091,463,223,1340,514,237,249,51,14,209,.5789474,.5401301,.1106291,.0303688,.3682079,.1562606,.0752616,64.34622
11154,10120,868,1259,6076,7335,2922,1254,581,3855,1521,610,933,267,29,539,.6209677,.7410643,.2120731,.0230342,.4809085,.2063858,.0956221,44.61284
11155,65789,4951,8226,37153,45379,16624,7591,3609,20875,8796,3892,4251,1205,283,2548,.5146435,.5167761,.1464867,.0344031,.447447,.2043173,.0971389,31.70761
11156,7682,511,827,4558,5385,1659,622,277,2175,761,302,516,139,25,349,.6829746,.623942,.1680774,.0302297,.3639754,.1364634,.0607723,63.24443
11157,10951,820,1178,6591,7769,2656,1328,665,3356,1536,761,700,208,96,539,.6573171,.5942275,.1765705,.0814941,.4029737,.2014869,.1008952,52.41721
11158,10368,969,1248,5587,6835,2264,864,407,3132,996,461,868,132,54,642,.6625387,.6955128,.1057692,.0432692,.4052264,.1546447,.0728477,51.39127
11159,18064,1475,2045,9962,12007,4323,1724,777,5477,1982,810,1154,258,33,912,.6183051,.5643032,.1261614,.0161369,.433949,.1730576,.0779964,65.79285
12001,92053,6099,10217,53704,63921,36980,17902,8142,45472,21463,8603,8492,3561,461,4537,.7438924,.8311638,.3485368,.0451209,.6885893,.3333457,.1516088,29.16694
12002,762565,56587,119875,428566,548441,323933,171587,93201,425166,210149,100882,101233,38562,7681,38650,.683019,.844488,.3216851,.0640751,.7558532,.4003747,.2174717,14.30406
12003,144,0,2,142,144,40,11,5,42,13,5,2,2,0,0,,1,1,0,.2816902,.0774648,.0352113,38.97436
12004,39082,2400,4141,23137,27278,14842,8293,3630,18089,9639,3810,3247,1346,180,1829,.7620834,.7841101,.3250422,.0434678,.6414834,.3584302,.1568916,24.04747
12005,70847,4798,7697,42059,49756,28475,14435,6437,34701,16719,6853,6226,2284,416,3363,.7009171,.8088866,.296739,.054047,.6770251,.3432083,.1530469,25.41101
13001,173036,12382,23550,97159,120709,79354,46003,21475,98181,54091,22690,18827,8088,1215,8552,.69068,.799448,.3434395,.0515924,.8167437,.4734816,.2210294,15.20851
13002,3347,250,321,1971,2292,1358,612,233,1604,672,243,246,60,10,187,.748,.7663552,.1869159,.0311526,.6889904,.3105023,.1182141,16.38248
13003,65421,5033,10319,33654,43973,26642,14707,6198,35237,18619,6693,8595,3912,495,3619,.7190542,.8329296,.3791065,.0479698,.7916444,.437006,.1841683,13.21138
13004,6931,460,689,3617,4306,2673,1160,405,3172,1306,418,499,146,13,304,.6608695,.724238,.2119013,.0188679,.7390102,.3207078,.1119712,20.84024
13005,8292,619,838,4753,5591,3103,1209,473,3730,1361,531,627,152,58,399,.6445881,.74821,.1813843,.0692124,.6528508,.2543657,.0995161,22.16521
13006,36489,2630,3910,17948,21858,12927,6179,2145,15579,6971,2248,2652,792,103,1700,.6463878,.6782609,.2025575,.0263427,.7202474,.3442723,.1195119,21.0737
13007,9841,570,1323,5997,7320,5282,3514,1821,6421,4048,1990,1139,534,169,330,.5789474,.8609222,.4036281,.12774,.8807737,.5859597,.3036518,19.21281
13008,2999,160,321,1758,2079,1260,550,229,1496,615,234,236,65,5,67,.41875,.7352025,.2024922,.0155763,.7167236,.3128555,.1302617,21.94293
13009,24163,1585,2215,14645,16860,10544,4533,1765,12123,4855,1806,1579,322,41,1037,.6542587,.7128668,.1453725,.0185102,.7199727,.3095254,.1205189,23.1393
13010,65980,4768,8102,33565,41667,27050,15159,7090,33165,17146,7507,6115,1987,417,2782,.5834731,.7547519,.2452481,.0514688,.805899,.4516312,.2112319,11.94722
13011,7289,500,629,4172,4801,2826,1153,477,3196,1239,482,370,86,5,341,.682,.5882353,.136725,.0079491,.677373,.2763663,.1143337,25.17086
13012,3342,217,319,1827,2146,1297,643,265,1542,762,279,245,119,14,151,.6958525,.7680251,.3730408,.0438871,.7099069,.3519431,.1450465,14.38255
13013,818,62,79,474,553,397,212,84,450,229,86,53,17,2,46,.7419355,.6708861,.2151899,.0253165,.8375527,.4472574,.1772152,19.3617
13014,83756,6547,10245,46223,56468,30157,13077,5559,37098,15679,5843,6941,2602,284,4303,.6572476,.6775012,.2539775,.0277208,.6524241,.2829111,.1202648,24.31443
13015,8695,626,1035,4270,5305,3253,1508,615,3957,1785,648,704,277,33,376,.600639,.6801932,.2676328,.0318841,.7618267,.3531616,.1440281,18.04609
13016,19427,1440,2220,9841,12061,6939,3453,1122,8406,3932,1174,1467,479,52,839,.5826389,.6608108,.2157658,.0234234,.7051113,.350879,.1140128,19.43667
13017,798,68,89,438,527,331,194,72,404,218,77,73,24,5,49,.7205882,.8202247,.2696629,.0561798,.7557077,.4429224,.1643836,34.03362
13018,10390,751,1063,5961,7024,4063,1416,632,4751,1569,653,688,153,21,445,.5925433,.6472248,.1439323,.0197554,.6815971,.237544,.1060225,18.29483
13019,3385,210,300,2059,2359,1551,726,275,1759,784,281,208,58,6,144,.6857143,.6933333,.1933333,.02,.7532783,.3525983,.13356,27.51213
13020,21565,1850,4441,10145,14586,7733,3323,1374,11254,3965,1500,3521,642,126,885,.4783784,.7928395,.144562,.028372,.7622474,.3275505,.1354362,22.93687
13021,8895,591,844,4429,5273,3426,1505,505,4048,1686,520,622,181,15,445,.7529611,.7369668,.214455,.0177725,.7735381,.3398058,.1140212,22.94186
13022,10813,928,1111,5408,6519,3867,1842,649,4642,2121,684,775,279,35,455,.4903017,.6975697,.2511251,.0315032,.7150518,.3406065,.1200074,21.01017
13023,11972,847,1118,7038,8156,4439,1622,568,5137,1823,591,698,201,23,565,.6670602,.6243291,.1797853,.0205725,.6307189,.2304632,.0807047,20.75754
13024,11874,806,1163,7046,8209,4648,2116,905,5420,2365,926,772,249,21,518,.6426799,.6638005,.2141015,.0180568,.659665,.3003122,.1284417,26.30691
13025,14769,1042,1534,8636,10170,5922,2527,1073,6983,2805,1114,1061,278,41,669,.6420345,.6916558,.1812256,.0267275,.6857342,.2926123,.1242473,21.57242
13026,15304,1113,1708,7405,9113,5228,2390,761,6377,2730,788,1149,340,27,729,.6549865,.6727166,.1990632,.015808,.7060094,.3227549,.1027684,19.76944
13027,14840,946,1582,8238,9820,5440,2602,892,6487,2827,915,1047,225,23,650,.6871036,.6618205,.142225,.0145386,.6603544,.3158534,.1082787,24.07965
13028,59770,4332,6371,35016,41387,26469,12802,4846,31347,14397,5044,4878,1595,198,3143,.7255309,.7656569,.2503532,.0310783,.7559116,.3656043,.1383939,17.95177
13029,28749,2820,7454,14643,22097,11927,7620,4336,18875,12353,5092,6948,4733,756,2428,.8609929,.932117,.6349611,.1014221,.8145189,.5203851,.2961142,14.9203
13030,7460,473,659,4426,5085,3113,1413,566,3655,1649,595,542,236,29,312,.6596195,.8224583,.3581184,.0440061,.7033439,.3192499,.1278807,31.66526
13031,4118,287,416,2461,2877,1653,766,291,1935,862,307,282,96,16,177,.6167247,.6778846,.2307692,.0384615,.6716782,.3112556,.1182446,13.21596
13032,3436,209,297,1980,2277,1430,602,234,1657,667,241,227,65,7,147,.7033493,.7643098,.2188552,.023569,.7222222,.3040404,.1181818,15.47486
13033,19480,4107,6599,6469,13068,5261,3277,1212,11525,5959,1244,6264,2682,32,3833,.9332846,.9492347,.4064252,.0048492,.8132632,.5065698,.1873551,21.49761
13034,19718,1440,2339,10176,12515,6533,2958,1068,7843,3337,1122,1310,379,54,923,.6409722,.5600684,.1620351,.0230868,.6420008,.290684,.1049528,18.96845
13035,33220,2348,4007,19823,23830,14338,6301,2596,17348,7304,2737,3010,1003,141,1625,.6920784,.7511854,.2503119,.0351884,.7233012,.3178631,.130959,16.98259
13036,3258,210,274,1847,2121,1326,728,233,1546,793,233,220,65,0,149,.7095238,.8029197,.2372263,0,.717921,.3941527,.1261505,22.43018
13037,8272,871,1018,4409,5427,2342,839,327,2845,932,342,503,93,15,427,.4902411,.4941061,.0913556,.0147348,.5311862,.1902926,.0741665,23.56538
13038,15722,1031,1472,9213,10685,5629,2253,835,6667,2639,886,1038,386,51,702,.6808923,.7051631,.2622283,.0346467,.6109845,.2445458,.0906328,25.68424
13039,6844,464,613,3671,4284,2589,1278,409,3043,1388,428,454,110,19,275,.5926724,.7406199,.1794454,.0309951,.7052574,.348134,.1114138,17.57293
13040,19226,1242,2144,10878,13022,6946,2532,1054,8361,2880,1132,1415,348,78,686,.552335,.6599814,.1623134,.0363806,.6385365,.2327634,.0968928,11.6538
13041,2897,196,317,1525,1842,1197,678,259,1434,768,267,237,90,8,138,.7040817,.7476341,.2839117,.0252366,.784918,.4445902,.1698361,27.46301
13042,52927,3917,6172,30399,36571,20734,10318,4071,25092,11703,4262,4358,1385,191,2570,.6561144,.706092,.2244005,.0309462,.6820619,.3394191,.1339189,18.92511
13043,5604,348,526,3422,3948,2747,1535,721,3157,1677,752,410,142,31,235,.6752874,.7794677,.269962,.0589354,.802747,.4485681,.2106955,13.65294
13044,8803,575,747,5330,6077,3240,1437,693,3691,1512,701,451,75,8,359,.6243478,.6037483,.1004016,.0107095,.6078799,.269606,.1300188,29.97932
14001,71622,5459,8776,42935,51711,27556,10048,4556,34534,12655,5033,6978,2607,477,3904,.7151493,.795123,.2970602,.0543528,.6418074,.2340282,.1061139,21.76253
14002,12264,851,1300,7405,8705,3482,1282,507,4393,1562,544,911,280,37,620,.7285547,.7007692,.2153846,.0284615,.4702228,.1731263,.0684673,48.63327
14003,16224,1329,2436,9550,11986,5277,1979,1065,7229,2795,1144,1952,816,79,947,.7125658,.8013136,.3349754,.0324302,.5525655,.2072251,.1115183,30.46834
14004,28630,2176,3261,16245,19506,10858,3668,1566,13220,4432,1691,2362,764,125,1436,.6599265,.7243177,.234284,.0383318,.6683903,.2257926,.0963989,14.38635
14005,5411,349,495,3435,3930,1947,599,265,2348,721,295,401,122,30,250,.7163324,.810101,.2464646,.0606061,.5668122,.1743814,.077147,41.90756
14006,39114,2738,4179,23728,27907,15720,5471,2517,19095,6618,2718,3375,1147,201,1943,.7096421,.8076095,.2744676,.0480976,.6625084,.2305715,.1060772,21.03888
14007,5867,423,578,3647,4225,1707,483,211,2186,649,240,479,166,29,310,.7328605,.8287197,.2871972,.050173,.4680559,.1324376,.0578558,27.76604
14008,18779,1311,1971,11611,13582,7584,2298,1106,9146,2668,1179,1562,370,73,912,.6956522,.7924911,.187722,.037037,.6531737,.1979158,.0952545,24.2366
14009,15084,1041,1535,9234,10769,5694,1670,752,6798,1894,796,1104,224,44,748,.7185399,.7192183,.1459283,.0286645,.6166342,.1808534,.0814382,26.53564
14010,168392,20650,48398,82173,130571,66463,38751,24657,111489,66605,30029,45026,27854,5372,15666,.758644,.9303277,.5755196,.1109963,.808818,.4715783,.3000621,16.61126
14011,36446,2655,3959,22180,26139,13811,3863,1733,16825,4658,1961,3014,795,228,1811,.6821092,.7613034,.2008083,.0575903,.6226781,.1741659,.0781335,23.18595
14012,16913,1081,1780,10592,12372,6371,1909,812,7821,2311,903,1450,402,91,798,.7382054,.8146067,.2258427,.0511236,.6014917,.1802304,.0766616,29.78307
14013,15283,1050,1603,9538,11141,4851,1430,572,6037,1808,610,1186,378,38,702,.6685714,.7398627,.2358079,.0237056,.5085972,.1499266,.0599706,27.46304
14014,32617,2550,4261,18071,22332,9998,3065,1167,13421,3924,1262,3423,859,95,1627,.6380392,.8033326,.2015959,.0222952,.5532621,.1696088,.0645786,24.19409
14015,52260,5929,12886,27576,40462,18247,8460,4511,29951,15463,5154,11704,7003,643,4942,.8335301,.9082726,.543458,.0498991,.6616986,.3067885,.1635843,19.96408
14016,5253655,377528,675332,3114630,3789962,2001891,1024911,531728,2487970,1248837,588485,486079,223926,56757,265782,.7040061,.719763,.3315791,.0840431,.642738,.3290635,.1707195,12.38103
14017,20818,1343,2180,13163,15343,8509,2913,1229,10227,3538,1348,1718,625,119,941,.7006701,.7880734,.2866972,.0545872,.6464332,.2213021,.0933678,22.22115
14018,11062,785,1252,6497,7749,3688,1174,493,4663,1433,521,975,259,28,527,.6713376,.778754,.206869,.0223642,.5676466,.1806988,.0758812,31.41071
14019,74624,9135,21072,36262,57334,27279,13786,8067,46992,26805,9457,19713,13019,1390,8106,.8873563,.9355068,.6178341,.0659643,.7522751,.3801776,.2224643,14.79862
14020,18108,1199,1918,11034,12952,7213,2250,1068,8708,2584,1175,1495,334,107,697,.5813178,.7794577,.1741397,.0557873,.6537067,.2039152,.0967917,20.17818
14021,19774,1331,2347,11804,14151,7833,2563,1106,9571,3051,1212,1738,488,106,782,.5875282,.7405198,.207925,.045164,.6635886,.2171298,.093697,21.53363
14022,658835,46625,78963,384525,463488,319721,191352,111557,385359,223226,120675,65638,31874,9118,35760,.7669705,.8312501,.4036574,.1154718,.83147,.4976321,.2901164,5.4788
14023,21725,1401,2182,13556,15738,8386,2642,1300,9965,3096,1410,1579,454,110,956,.6823697,.723648,.208066,.0504125,.6186191,.1948953,.0958985,28.61994
14024,7961,451,903,4946,5849,2914,1038,336,3593,1244,345,679,206,9,293,.6496674,.751938,.2281285,.0099668,.5891629,.2098666,.0679337,31.95759
14025,30944,2436,3777,17494,21271,10909,3836,1652,13981,4601,1776,3072,765,124,1684,.6912972,.8133439,.2025417,.0328303,.6235852,.2192752,.0944324,23.92646
14026,22167,1488,2526,13581,16107,7201,2086,894,8836,2466,957,1635,380,63,949,.6377688,.6472684,.1504355,.0249406,.5302261,.1535969,.0658273,28.73635
14027,15265,1097,1625,9486,11111,6571,2180,819,7827,2573,879,1256,393,60,732,.6672744,.7729231,.2418462,.0369231,.692705,.2298124,.0863378,20.3323
14028,43201,2693,4342,27391,31733,14285,4671,1842,17406,5559,1937,3121,888,95,1837,.6821389,.7187932,.204514,.0218793,.5215217,.1705305,.0672484,31.81391
14029,43687,3008,4676,26645,31321,16648,5142,2069,20243,6138,2203,3595,996,134,2164,.7194149,.7688195,.2130026,.028657,.6248077,.1929818,.0776506,20.28659
14030,7590,527,777,4699,5476,2152,725,226,2681,873,237,529,148,11,397,.7533207,.6808237,.1904762,.014157,.4579698,.1542881,.0480953,52.61278
14031,16661,1165,1786,10180,11966,5781,1611,732,7120,1964,783,1339,353,51,804,.6901287,.74972,.1976484,.0285554,.5678782,.1582515,.0719057,30.60844
14032,30582,2248,3645,17658,21303,11784,3568,1721,14613,4181,1891,2829,613,170,1418,.6307829,.7761317,.1681756,.0466392,.6673462,.2020614,.0974629,13.05361
14033,9172,575,930,5954,6884,2799,901,379,3528,1140,410,729,239,31,388,.6747826,.783871,.2569892,.0333333,.4701041,.1513268,.0636547,38.54219
14034,23877,1846,2721,14576,17297,9915,3503,1641,12131,4157,1787,2216,654,146,1377,.7459372,.8144065,.2403528,.0536567,.6802278,.2403266,.1125823,25.91195
14035,5383,316,495,3441,3936,1446,465,191,1778,579,204,332,114,13,169,.5348101,.670707,.230303,.0262626,.4202267,.1351351,.0555071,43.87947
14036,9114,644,1035,5409,6444,3357,963,409,4149,1198,454,792,235,45,400,.621118,.7652174,.2270531,.0434783,.6206323,.1780366,.0756147,26.67154
14037,57968,4152,6188,34148,40336,23167,7970,3790,27885,9300,3990,4718,1330,200,2909,.7006262,.7624434,.2149321,.0323206,.6784292,.2333958,.1109875,19.49683
14038,32976,2343,3520,20139,23659,12793,3793,1743,15470,4413,1866,2677,620,123,1654,.7059326,.7605113,.1761364,.0349432,.6352351,.188341,.0865485,21.39542
14039,61522,7416,19098,29729,48827,20714,12688,7853,38579,25212,9642,17865,12524,1789,6510,.8778317,.9354383,.6557755,.0936747,.6967607,.4267887,.2641529,28.46034
14040,11318,938,1334,6667,8001,3634,1178,510,4745,1500,538,1111,322,28,666,.7100213,.8328336,.2413793,.0209895,.5450727,.1766912,.0764962,32.92035
14041,36552,2381,3977,22388,26365,12614,5046,2389,15650,6064,2591,3036,1018,202,1594,.6694666,.7633895,.2559718,.0507921,.5634269,.2253886,.106709,27.73364
14042,20538,1825,2997,11587,14584,6866,2201,954,9332,3092,995,2466,891,41,1428,.7824658,.8228228,.2972973,.0136803,.5925606,.1899543,.0823336,21.47878
14043,23520,1752,2512,13789,16301,8928,2803,1371,10910,3228,1487,1982,425,116,1249,.7128996,.7890127,.1691879,.0461783,.6474726,.203278,.0994271,24.89181
14044,9624,713,1121,6102,7223,3242,1330,485,4024,1616,507,782,286,22,512,.7180926,.6975914,.2551293,.0196253,.5313012,.2179613,.0794821,40.80608
14045,278405,20682,34611,156040,190651,110136,51645,26107,134877,59864,28077,24741,8219,1970,13944,.6742095,.7148305,.2374679,.0569183,.705819,.3309728,.1673097,8.583183
14046,102926,8157,13284,57881,71165,35314,12939,6143,45324,16495,6737,10010,3556,594,5967,.7315189,.7535381,.2676904,.0447154,.6101139,.2235449,.1061315,15.51488
14047,37202,2962,4243,20482,24725,15752,6150,2947,19076,7141,3129,3324,991,182,2038,.6880486,.783408,.2335612,.0428942,.7690655,.3002636,.1438824,12.62204
14048,61607,4502,7571,37475,45046,25616,9676,4149,31542,11842,4447,5926,2166,298,2958,.6570413,.7827235,.2860917,.0393607,.683549,.2581988,.1107138,14.7537
14049,440372,40476,61224,245283,306507,190264,107034,61469,237062,122706,64862,46798,15672,3393,22660,.5598379,.7643734,.255978,.0554194,.7756917,.4363694,.2506044,7.9627
14050,112033,8153,13298,67806,81104,42108,14370,6059,52143,17772,6679,10035,3402,620,5733,.7031767,.7546248,.2558279,.0466236,.621007,.2119281,.0893579,12.4199
14051,17807,1157,1826,11201,13027,6938,2244,871,8328,2716,906,1390,472,35,861,.744166,.7612267,.2584885,.0191676,.619409,.2003393,.0777609,27.38553
14052,36328,2647,4256,21582,25838,14632,5154,2129,17903,6084,2299,3271,930,170,1789,.6758595,.768562,.218515,.0399436,.6779724,.2388101,.098647,19.12502
14053,41381,3043,5453,24638,30091,15600,5215,2494,19249,6105,2719,3649,890,225,1931,.6345711,.6691729,.1632129,.0412617,.6331683,.2116649,.1012257,17.45402
14054,31802,2581,4423,19361,23784,12861,5030,2307,16466,6298,2552,3605,1268,245,1862,.7214258,.8150576,.2866833,.0553923,.6642736,.2598006,.1191571,15.86318
14055,37467,4943,11270,18423,29693,13700,6834,4006,24341,13690,4795,10641,6856,789,4388,.88772,.9441881,.6083407,.0700089,.7436357,.3709494,.2174456,24.01763
14056,147897,10594,15917,85085,101002,63714,29778,14561,76105,33656,15353,12391,3878,792,7459,.7040778,.7784758,.2436389,.0497581,.7488276,.3499794,.1711348,10.44644
14057,119149,12706,27709,62015,89724,47136,24179,14119,72735,39652,16373,25599,15473,2254,10634,.8369274,.9238514,.5584106,.0813454,.7600742,.3898895,.2276707,16.84013
14058,131375,9197,16174,76926,93100,52667,20161,9956,65134,24419,10983,12467,4258,1027,6469,.7033815,.770805,.263262,.063497,.684645,.2620831,.1294231,15.32366
14059,49384,3508,5559,30180,35739,18198,5167,2376,22684,6395,2569,4486,1228,193,2310,.6584949,.8069797,.220903,.0347185,.6029821,.1712061,.0787276,24.41623
14060,247691,18217,30749,146826,177575,92222,34741,16129,116200,43050,17520,23978,8309,1391,12723,.6984136,.7797977,.2702202,.0452372,.628104,.2366134,.1098511,13.61412
14061,43523,3239,4937,26323,31260,14851,5430,2317,18526,6494,2498,3675,1064,181,2033,.6276628,.7443792,.2155155,.0366619,.5641834,.2062835,.0880219,27.35318
14062,14479,1006,1496,8725,10221,5906,1933,834,7142,2229,906,1236,296,72,778,.7733598,.8262032,.197861,.0481283,.6769055,.2215473,.0955874,21.61916
14063,19492,1326,2067,11557,13624,6970,2097,958,8373,2442,1031,1403,345,73,922,.6953243,.6787615,.1669086,.0353169,.6030977,.1814485,.0828935,22.5701
14064,14990,1012,1556,9467,11023,5031,1875,797,6171,2160,819,1140,285,22,719,.7104743,.7326478,.183162,.0141388,.5314249,.1980564,.0841872,34.60423
14065,11700,855,1055,7146,8201,4789,1787,910,5596,2027,969,807,240,59,643,.7520468,.7649289,.2274881,.0559242,.6701651,.25007,.127344,21.05377
14066,19286,1437,1977,11383,13360,7678,2375,982,9194,2755,1043,1516,380,61,1000,.6958942,.7668184,.1922104,.0308548,.6745147,.2086445,.086269,26.61537
14067,20117,1532,2333,11940,14273,7137,2052,968,9060,2424,1066,1923,372,98,1043,.6808094,.8242606,.1594514,.042006,.5977387,.1718593,.081072,13.90946
14068,31686,2160,3469,19557,23026,11342,3300,1589,14078,3824,1714,2736,524,125,1321,.6115741,.7886999,.1510522,.0360334,.5799458,.1687375,.0812497,26.64252
14069,37502,3082,5194,22232,27426,15009,5690,3144,19363,7543,3433,4354,1853,289,2336,.7579494,.838275,.3567578,.0556411,.675108,.2559374,.1414178,20.58126
14070,14546,921,1557,8981,10538,5309,1906,824,6388,2212,864,1079,306,40,610,.6623235,.6929994,.1965318,.0256904,.5911369,.2122258,.0917493,23.19647
14071,46338,3583,5179,27007,32186,18032,6368,2819,21895,7488,3033,3863,1120,214,2560,.714485,.7458969,.216258,.0413207,.6676788,.2357907,.1043803,19.06417
14072,200466,14617,27457,116210,143667,80502,36725,18669,102375,46153,20620,21873,9428,1951,10439,.7141684,.7966275,.3433733,.0710566,.6927287,.3160227,.1606488,14.80175
14073,21714,1410,2319,13276,15595,7298,2357,1071,9070,2856,1131,1772,499,60,972,.6893617,.7641225,.215179,.0258732,.5497138,.1775384,.0806719,28.81128
14074,16581,1200,1650,9991,11641,6997,2631,1386,8339,2974,1459,1342,343,73,889,.7408333,.8133333,.2078788,.0442424,.7003303,.263337,.1387248,18.34398
14075,18896,1146,1809,12021,13830,7363,2128,931,8711,2493,1004,1348,365,73,802,.6998255,.7451631,.2017689,.0403538,.6125115,.1770235,.0774478,34.18507
14076,4404,442,512,2640,3152,1288,357,139,1554,404,148,266,47,9,225,.5090498,.5195313,.0917969,.0175781,.4878788,.1352273,.0526515,47.78805
14077,8840,632,927,5277,6204,2477,881,357,3076,1052,380,599,171,23,393,.6218355,.6461704,.184466,.0248112,.4693955,.1669509,.0676521,51.78854
14078,6085,438,716,3554,4270,2339,839,329,2925,994,358,586,155,29,304,.6940639,.8184357,.2164804,.0405028,.6581317,.236072,.0925718,16.71847
14079,35652,2362,4589,21589,26178,11962,3281,1476,15505,3942,1605,3543,661,129,1391,.5889077,.7720636,.1440401,.0281107,.5540785,.1519755,.0683682,24.40829
14080,17587,1368,2140,10696,12836,6426,2437,1103,8070,3077,1183,1644,640,80,1014,.741228,.7682243,.2990654,.0373832,.6007853,.2278422,.1031227,26.43671
14081,165968,12411,22021,96766,118787,67447,26589,11765,84950,33155,12927,17503,6566,1162,8828,.7113045,.7948322,.2981699,.0527678,.6970114,.2747763,.121582,11.21356
14082,267531,21078,34114,148954,183068,87999,37617,17034,113307,46675,18350,25308,9058,1316,15036,.7133504,.7418655,.2655215,.0385765,.5907797,.2525411,.1143574,20.57899
14083,28448,1857,2988,18383,21371,9323,3242,1257,11453,3953,1358,2130,711,101,1319,.7102854,.7128514,.2379518,.0338019,.5071533,.1763586,.0683784,39.86558
14084,176089,12055,21047,106711,127758,77246,35883,19926,93745,42195,21879,16499,6312,1953,8455,.7013687,.7839122,.2999002,.0927923,.7238804,.3362634,.1867286,15.60087
14085,8365,530,788,5298,6086,3216,914,417,3809,1053,452,593,139,35,373,.7037736,.7525381,.1763959,.0444162,.6070215,.1725179,.0787089,32.25769
14086,6142,471,707,3785,4492,2282,625,279,2871,699,306,589,74,27,338,.7176221,.8330976,.1046676,.0381895,.6029062,.1651255,.073712,31.69356
14087,23923,1718,2556,14482,17038,8792,2608,1083,10852,3113,1173,2060,505,90,1168,.6798603,.8059468,.1975743,.0352113,.6070985,.1800856,.0747825,29.6701
14088,7389,523,747,4465,5212,3069,973,416,3667,1132,446,598,159,30,399,.7629063,.8005355,.2128514,.0401606,.687346,.2179171,.0931691,24.12583
14089,49536,3626,5813,29664,35477,20026,7239,3309,24602,8521,3562,4576,1282,253,2447,.6748483,.7872011,.2205402,.0435231,.6750944,.2440332,.1115494,17.90943
14090,132078,9565,15697,76121,91818,52312,19618,8992,64535,23180,9806,12223,3562,814,6775,.7083116,.7786838,.2269223,.051857,.6872216,.2577212,.1181277,10.85461
14091,17765,1033,1584,12066,13650,6037,2085,947,7135,2398,1020,1098,313,73,688,.6660213,.6931818,.197601,.0460859,.5003315,.1727996,.078485,29.49243
14092,95222,6793,11101,56930,68031,35488,12849,5520,43830,15254,5982,8342,2405,462,4550,.6698071,.7514638,.2166471,.0416179,.623362,.2256982,.0969612,19.26662
14093,13713,982,1663,8206,9869,5104,2110,715,6311,2587,777,1207,477,62,702,.7148676,.7257968,.286831,.037282,.6219839,.2571289,.0871314,20.47136
14094,21943,1661,2807,12867,15674,8397,3281,1635,10617,4148,1823,2220,867,188,1192,.71764,.79088,.3088707,.0669754,.6525997,.2549934,.1270692,22.89321
14095,15472,991,1577,9683,11260,4828,1710,671,6132,2083,706,1304,373,35,722,.728557,.8268865,.236525,.022194,.4986058,.1765982,.0692967,24.67835
14096,18059,1151,1860,11366,13226,5677,1814,699,7123,2215,731,1446,401,32,793,.6889661,.7774193,.2155914,.0172043,.4994721,.1595988,.0614992,29.60954
14097,17864,1175,1878,11686,13564,6511,2308,926,7920,2786,1003,1409,478,77,750,.6382979,.7502663,.2545261,.0410011,.5571624,.1975013,.0792401,28.36274
14098,65970,5089,7962,37832,45794,23571,8059,3306,29440,9781,3620,5869,1722,314,3366,.6614266,.7371264,.2162773,.0394373,.623044,.2130207,.0873863,18.67674
14099,324460,24092,39570,177128,216698,124296,53147,25383,154770,62996,27345,30474,9849,1962,15858,.6582268,.7701289,.2489007,.049583,.7017298,.3000486,.1433031,11.12077
14100,56538,3651,6225,35549,41774,20795,8233,3734,25584,10259,4139,4789,2026,405,2418,.6622843,.7693173,.3254618,.0650602,.5849673,.2315958,.1050381,28.2451
14101,250884,18748,30547,145723,176270,98408,40545,19733,120016,47980,21493,21608,7435,1760,12044,.6424152,.707369,.2433954,.0576161,.6753086,.2782333,.1354145,11.83398
14102,33320,2450,3935,18918,22853,13325,5320,2562,16546,6385,2699,3221,1065,137,1793,.7318367,.8185515,.270648,.0348158,.7043557,.2812137,.1354266,15.75556
15001,29619,2191,3413,16069,19482,10670,3059,1373,13144,3543,1457,2474,484,84,1423,.6494751,.7248755,.1418107,.0246118,.6640115,.1903666,.085444,15.06456
15002,294335,22249,38316,166389,204705,121905,53278,24929,150529,63166,26863,28624,9888,1934,15928,.7158973,.7470508,.2580645,.050475,.7326506,.3202015,.1498236,12.50177
15003,65088,4663,7155,37546,44701,25719,10060,5553,30730,11304,5967,5011,1244,414,3085,.6615912,.7003494,.1738644,.0578616,.6849997,.267938,.1478986,15.9379
15004,10218,776,1033,6056,7089,4246,1209,571,5043,1341,609,797,132,38,559,.7203608,.7715392,.1277831,.0367861,.7011229,.1996367,.0942867,25.44136
15005,15570,1150,1711,9237,10948,5833,1307,660,7082,1607,722,1249,300,62,732,.6365218,.7299825,.1753361,.0362361,.6314821,.1414962,.0714518,17.83393
15006,36446,2813,3885,21624,25509,16107,6284,3394,18933,7056,3646,2826,772,252,2002,.7116957,.7274131,.198713,.0648649,.7448668,.290603,.1569552,18.32377
15007,12377,802,1304,7462,8766,4970,2155,1068,5906,2407,1102,936,252,34,501,.6246883,.7177914,.1932515,.0260736,.6660413,.2887966,.1431252,26.5713
15008,19722,1401,2108,11763,13871,8007,2210,953,9532,2524,1012,1525,314,59,992,.7080657,.7234345,.1489564,.0279886,.6806937,.1878772,.0810167,21.61562
15009,40936,2816,4464,24387,28851,17035,4838,2168,20441,5444,2289,3406,606,121,1954,.6938921,.7629929,.1357527,.0271057,.6985279,.1983844,.0888998,16.7329
15010,88838,6653,10806,50780,61586,32315,11563,4677,40156,13945,5125,7841,2382,448,4245,.638058,.7256154,.2204331,.0414585,.6363726,.2277078,.0921032,18.61446
15011,24862,1703,2809,15130,17939,9858,2713,1249,11981,3190,1338,2123,477,89,1112,.6529654,.755785,.1698113,.0316839,.6515532,.1793126,.0825512,23.53749
15012,31545,2145,3479,18898,22377,12336,3625,1764,14924,4132,1859,2588,507,95,1349,.6289044,.7438919,.1457315,.0273067,.6527675,.1918192,.0933432,19.10777
15013,9820,722,1183,5641,6824,2771,714,316,3577,883,343,806,169,27,364,.5041551,.6813187,.1428571,.0228233,.491225,.1265733,.0560184,42.1621
15014,27836,1895,3050,16418,19468,9549,2662,1167,11541,3160,1302,1992,498,135,1077,.5683377,.6531147,.1632787,.0442623,.5816177,.1621391,.0710805,27.6496
15015,34291,2549,3685,19628,23313,11918,3629,1879,14689,4214,1971,2771,585,92,1612,.6324049,.7519674,.1587517,.0249661,.6071938,.1848889,.0957306,17.75602
15016,23841,1780,2798,13411,16209,8263,2170,1080,10259,2514,1161,1996,344,81,1117,.6275281,.7133667,.122945,.0289492,.616136,.1618075,.0805309,26.41586
15017,33606,2476,3993,18949,22942,12933,3683,1605,15772,4293,1738,2839,610,133,1652,.6672052,.7109942,.1527673,.0333083,.6825162,.1943638,.084701,15.93288
15018,128587,12562,24059,69925,93984,46422,17977,10440,66890,28266,11794,20468,10289,1354,9972,.7938226,.8507419,.427657,.0562783,.6638827,.2570897,.1493028,17.11174
15019,34238,2854,4504,18962,23466,11056,3460,1941,14599,4171,2075,3543,711,134,1973,.6913105,.7866341,.1578597,.0297513,.5830609,.1824702,.1023626,23.48335
15020,137330,9792,16271,78491,94762,51497,19216,9632,62484,22390,10441,10987,3174,809,6405,.6541054,.6752505,.195071,.0497204,.6560879,.2448179,.1227147,12.58812
15021,28272,1968,3074,16292,19366,9243,2639,1180,11305,2931,1272,2062,292,92,1207,.613313,.6707873,.0949902,.0299284,.5673336,.1619813,.0724282,23.45558
15022,61169,4515,7123,35925,43048,22487,7906,3801,27703,9396,4083,5216,1490,282,3024,.6697674,.7322757,.2091815,.0395901,.6259429,.2200696,.1058038,20.9977
15023,19033,1414,2051,11419,13470,7219,1827,908,8689,2093,977,1470,266,69,979,.6923621,.7167236,.1296928,.0336421,.632192,.1599965,.0795166,21.06569
15024,19612,1526,2180,10723,12903,5746,1533,836,7207,1761,903,1461,228,67,934,.6120577,.6701835,.1045872,.0307339,.5358575,.1429637,.0779633,33.20804
15025,19335,1383,2052,11715,13767,8030,2227,998,9543,2480,1044,1513,253,46,900,.6507592,.7373294,.1232943,.0224172,.685446,.1900982,.0851899,21.20905
15026,33156,2475,4036,19858,23894,12324,3960,1780,15473,5016,1975,3149,1056,195,1674,.6763636,.780228,.2616452,.0483152,.6206063,.1994158,.0896364,25.79697
15027,80934,6782,10915,46199,57114,28949,9457,4497,36966,12271,4921,8017,2814,424,4792,.7065762,.7344938,.2578104,.0388456,.6266153,.2047014,.0973398,15.72877
15028,30416,1946,3011,18982,21993,11149,2983,1380,13376,3483,1451,2227,500,71,1172,.6022611,.7396214,.1660578,.0235802,.5873459,.1571489,.0727005,29.80142
15029,82027,5998,7875,47451,55326,38263,20508,12210,43946,22384,12687,5683,1876,477,4666,.777926,.7216508,.2382222,.0605714,.8063686,.4321932,.2573181,12.9209
15030,43939,3257,4578,24953,29531,18338,6221,2828,21543,6981,3017,3205,760,189,2167,.6653362,.7000874,.1660114,.0412844,.7349016,.2493087,.1133331,15.59014
15031,27276,2106,3194,15430,18624,9637,2564,1044,11968,3035,1135,2331,471,91,1318,.6258309,.7298059,.147464,.0284909,.6245626,.1661698,.0676604,25.81161
15032,69804,5671,7704,39708,47412,30348,11394,5713,35944,12773,5996,5596,1379,283,3784,.6672544,.7263759,.1789979,.0367342,.7642792,.2869447,.1438753,11.97618
15033,53336,3871,5896,31384,37280,19090,5153,2307,23129,5959,2532,4039,806,225,2409,.6223198,.6850407,.1367029,.0381615,.6082717,.1641919,.0735088,20.63553
15034,86896,6438,10162,49659,59821,34000,11370,5463,41211,13269,5860,7211,1899,397,4369,.6786269,.7096044,.1868727,.0390671,.6846694,.2289615,.1100103,15.17264
15035,35596,2723,4583,20507,25090,14607,4492,2102,18014,5438,2252,3407,946,150,1915,.7032685,.7433995,.206415,.0327297,.7122934,.2190472,.1025016,17.05816
15036,36523,2532,4299,21244,25543,12703,3346,1566,15732,4002,1722,3029,656,156,1523,.6015008,.7045825,.1525936,.0362875,.5979571,.1575033,.0737149,21.08478
15037,26138,2295,3761,13878,17639,8925,2647,1292,11920,3571,1392,2995,924,100,1640,.7145969,.7963307,.2456793,.0265887,.6431042,.1907335,.093097,21.76908
15038,23239,1740,2450,13618,16068,8174,2008,939,9969,2250,988,1795,242,49,1149,.6603448,.7326531,.0987755,.02,.600235,.1474519,.0689529,19.77649
15039,30419,2568,4304,17313,21617,10793,3742,2112,14081,4929,2248,3288,1187,136,1759,.6849688,.7639405,.27579,.0315985,.6234044,.2161382,.1219893,25.91036
15040,22854,1828,2763,12772,15535,7428,1908,872,9321,2173,903,1893,265,31,1061,.5804157,.6851249,.0959102,.0112197,.5815847,.1493893,.0682743,25.21158
15041,77240,6334,9427,43257,52684,30646,11475,5732,37324,13190,6108,6678,1715,376,4126,.6514051,.7083908,.1819243,.0398854,.7084634,.265275,.1325103,13.3531
15042,41838,3944,6493,24760,31253,15465,5648,2440,20702,7680,2655,5237,2032,215,2914,.7388438,.8065609,.3129524,.0331126,.6245961,.2281099,.098546,26.0994
15043,59555,4215,7366,34082,41448,23327,8229,4139,28730,9839,4552,5403,1610,413,2935,.6963227,.7335053,.2185718,.0560684,.6844375,.2414471,.1214424,18.55908
15044,25550,1954,2858,13161,16019,6928,2058,909,8286,2322,942,1358,264,33,932,.4769703,.4751574,.0923723,.0115465,.5264038,.1563711,.0690677,28.84988
15045,522965,40629,68429,290394,358823,183959,64509,29309,234117,78980,32048,50158,14471,2739,27642,.6803515,.7329933,.2114747,.0400269,.6334807,.222143,.1009284,14.20026
15046,108632,7784,12648,63540,76188,40462,13806,6744,49299,15884,7089,8837,2078,345,5004,.6428571,.6986876,.1642947,.027277,.6367957,.2172804,.1061379,12.94596
15047,42472,2798,4453,25555,30008,14764,3576,1723,17869,4197,1909,3105,621,186,1697,.6065046,.6972827,.1394565,.0417696,.5777343,.1399335,.0674232,24.8055
15048,139336,10266,16617,81189,97806,52384,16469,8421,64531,19933,9079,12147,3464,658,7071,.6887785,.7309984,.2084612,.039598,.6452106,.2028477,.1037209,15.01224
15049,765233,56630,104820,444056,548876,299616,136146,72588,375217,163739,80887,75601,27593,8299,36028,.6361999,.7212459,.2632417,.0791738,.6747257,.3065965,.1634659,14.55215
15050,39155,2829,4516,22766,27282,15287,4880,2374,18584,5615,2524,3297,735,150,1760,.622128,.7300708,.1627547,.0332152,.6714838,.2143547,.1042783,18.60322
15051,11001,803,1207,6274,7481,3659,958,460,4514,1117,488,855,159,28,496,.6176837,.7083678,.1317316,.023198,.5832005,.1526937,.0733185,29.89662
15052,39820,2886,5357,21905,27262,15375,4399,1709,19553,5242,1848,4178,843,139,1732,.6001386,.7799141,.1573642,.0259474,.7018945,.2008217,.0780187,21.74213
15053,98785,11894,29991,48024,78015,35888,21603,15030,63887,40227,18391,27999,18624,3361,10323,.8679166,.9335801,.6209863,.112067,.747293,.4498376,.3129685,18.26589
15054,35501,2809,4625,20979,25604,15041,4498,2284,18680,5719,2495,3639,1221,211,2006,.7141331,.7868108,.264,.0456216,.7169551,.2144049,.1088708,17.27187
15055,51999,4023,5774,29217,34991,18970,5608,2762,22907,6337,2868,3937,729,106,2586,.6428039,.6818497,.1262556,.0183582,.6492795,.191943,.094534,18.71172
15056,14844,1157,1606,8409,10015,5446,1564,694,6595,1794,750,1149,230,56,789,.681936,.7154421,.1432129,.0348692,.6476395,.1859912,.0825306,23.56999
15057,35443,2480,4219,20049,24268,12716,3708,1474,15518,4200,1569,2802,492,95,1584,.6387097,.6641384,.1166153,.0225172,.6342461,.1849469,.0735199,16.69649
15058,5114,393,574,3025,3599,1640,388,239,2029,443,255,389,55,16,241,.6132315,.6777003,.0958188,.0278746,.5421488,.1282645,.0790083,25.41422
15059,18677,1320,2119,11166,13285,6054,1577,781,7416,1823,823,1362,246,42,803,.6083333,.642756,.1160925,.0198207,.5421816,.1412323,.0699445,32.39377
15060,15841,1221,1589,9488,11077,5440,1519,668,6582,1718,696,1142,199,28,841,.6887797,.718691,.125236,.0176211,.5733558,.160097,.0704047,30.2143
15061,16372,1226,1693,9989,11682,6714,1684,814,7975,1987,895,1261,303,81,821,.6696574,.7448317,.1789722,.0478441,.6721393,.1685854,.0814896,28.59218
15062,19346,1444,2394,11231,13625,5842,1548,704,7509,1852,759,1667,304,55,821,.5685595,.6963242,.1269841,.0229741,.5201674,.1378328,.0626836,29.21512
15063,13465,923,1468,8318,9786,4712,1211,525,5807,1398,546,1095,187,21,506,.5482123,.7459128,.1273842,.0143052,.5664823,.1455879,.0631161,31.05954
15064,119816,9618,16850,64843,81693,48326,18695,9548,62351,24084,10573,14025,5389,1025,6867,.7139738,.8323442,.319822,.0608309,.745277,.2883118,.147248,10.29333
15065,26414,1950,3161,15124,18285,9695,3184,1469,12228,3771,1603,2533,587,134,1309,.6712821,.8013287,.1857007,.0423916,.6410341,.2105263,.0971304,27.85013
15066,13258,937,1464,7702,9166,4864,1415,617,5863,1639,683,999,224,66,664,.7086446,.682377,.1530055,.045082,.6315243,.1837185,.0801091,27.11334
15067,29163,3107,5285,16353,21638,11453,3591,1978,15836,5418,2136,4383,1827,158,2428,.7814612,.8293283,.3456954,.0298959,.7003608,.2195927,.1209564,19.36
15068,29997,2128,3333,17629,20962,11357,2897,1381,13660,3296,1477,2303,399,96,1379,.6480263,.6909691,.119712,.0288029,.6442226,.1643315,.0783368,20.46461
15069,24398,1764,2765,13868,16633,7836,1904,1064,9886,2234,1155,2050,330,91,1110,.6292517,.7414105,.119349,.0329114,.5650418,.1372945,.0767234,26.22209
15070,19604,1447,2159,11185,13344,6992,1755,839,8429,2045,922,1437,290,83,1010,.6979958,.6655859,.1343215,.0384437,.6251229,.1569066,.0750112,24.53427
15071,241617,19133,34781,140911,175692,95204,38793,20575,122960,51754,22744,27756,12961,2169,14636,.7649611,.7980219,.372646,.0623616,.6756321,.2753014,.1460142,11.32692
15072,20422,1511,2325,11358,13683,5516,1343,602,6778,1638,638,1262,295,36,888,.5876903,.5427957,.1268817,.0154839,.4856489,.1182427,.0530023,31.38726
15073,39887,2809,4425,23023,27448,14607,4176,1966,17617,4755,2097,3010,579,131,1687,.6005696,.680226,.1308475,.0296045,.6344525,.1813838,.0853929,17.40619
15074,19361,1489,2355,11214,13569,6590,2010,942,8371,2510,1044,1781,500,102,976,.6554735,.7562633,.2123142,.0433121,.5876583,.1792402,.0840021,31.76107
15075,21997,1643,2333,12583,14916,6620,1960,818,8121,2239,896,1501,279,78,926,.5636032,.6433776,.1195885,.0334333,.5261067,.1557657,.0650083,27.17192
15076,24694,1948,3407,14251,17658,10244,3305,1389,13010,4303,1479,2766,998,90,1446,.7422998,.8118579,.2929263,.0264162,.7188268,.2319136,.0974668,22.6678
15077,21107,1274,2086,13180,15266,8269,2226,1026,9706,2599,1097,1437,373,71,869,.6821036,.6888782,.1788111,.0340364,.62739,.1688923,.0778452,26.90174
15078,7153,579,747,4289,5036,2188,521,241,2687,581,248,499,60,7,365,.6303973,.6680053,.0803213,.0093708,.5101422,.1214735,.0561903,28.71658
15079,121702,14382,34340,59321,93661,45557,23358,15141,77683,44485,18836,32126,21127,3695,12502,.8692811,.9355271,.61523,.1076005,.7679743,.393756,.2552384,13.49443
15080,16819,1175,1802,9982,11784,6744,1775,821,8043,2042,894,1299,267,73,794,.6757447,.7208657,.1481687,.0405105,.6756161,.1778201,.082248,18.65147
15081,6860,516,747,3955,4702,2460,743,355,2942,843,367,482,100,12,366,.7093023,.6452476,.1338688,.0160643,.6219975,.1878635,.0897598,26.73222
15082,167515,11927,22865,101711,124576,65316,25538,12730,83136,32333,14209,17820,6795,1479,8228,.6898633,.7793571,.2971791,.064684,.6421725,.2510839,.1251585,21.59348
15083,18229,1163,1858,11268,13126,6816,1819,877,8135,2115,954,1319,296,77,735,.6319863,.7099031,.1593111,.0414424,.6048988,.1614306,.077831,23.31714
15084,112385,9926,19769,64378,84147,44000,18920,10465,60477,27152,11593,16477,8232,1128,7432,.7487407,.8334767,.4164095,.057059,.6834633,.2938892,.1625555,21.47239
15085,36640,3174,5185,20707,25892,13868,4582,2450,17765,5967,2608,3897,1385,158,2240,.7057341,.7515911,.2671167,.0304725,.6697252,.2212778,.1183175,16.79679
15086,8976,663,915,5291,6206,3440,931,437,4110,1099,470,670,168,33,453,.6832579,.7322404,.1836066,.0360656,.6501607,.1759592,.0825931,25.12827
15087,41474,2969,4502,23480,27982,16738,6486,3189,20122,7587,3388,3384,1101,199,2101,.7076457,.7516659,.244558,.0442026,.712862,.2762351,.1358177,27.23637
15088,21932,1582,2509,12496,15005,6500,1610,744,8123,1944,805,1623,334,61,915,.5783818,.6468713,.1331208,.0243125,.5201665,.1288412,.0595391,30.4343
15089,76058,5694,8722,45021,53743,28708,9687,4547,34725,11389,4794,6017,1702,247,3804,.6680716,.6898647,.1951387,.0283192,.637658,.2151663,.1009973,18.07893
15090,25401,1874,2939,14607,17546,10076,2978,1301,12277,3466,1425,2201,488,124,1375,.7337247,.7488942,.1660429,.0421912,.6898063,.2038749,.0890669,16.47218
15091,23867,1525,2514,14310,16824,9540,2655,1219,11473,3099,1314,1933,444,95,1023,.6708197,.7688942,.176611,.0377884,.6666667,.1855346,.0851852,19.5517
15092,26215,1860,3054,15102,18156,10764,2851,1089,12950,3199,1173,2186,348,84,1320,.7096774,.7157826,.1139489,.0275049,.7127533,.1887829,.0721097,16.19748
16001,9509,605,902,6033,6935,4137,1328,531,4878,1536,579,741,208,48,462,.7636364,.8215078,.2305987,.0532151,.6857285,.2201227,.0880159,34.24569
16002,5731,413,536,3687,4223,2581,897,365,3018,1041,390,437,144,25,320,.7748184,.8152985,.2686567,.0466418,.7000271,.2432872,.0989965,32.76866
16003,15108,1129,1547,8923,10470,5576,1725,839,6824,1976,882,1248,251,43,837,.7413641,.8067227,.1622495,.0277957,.624902,.1933206,.0940267,40.50445
16004,15511,1111,1577,9622,11199,5967,2176,877,7110,2505,927,1143,329,50,755,.6795679,.7247939,.208624,.0317058,.6201413,.2261484,.0911453,36.37437
16005,8559,582,811,5385,6196,3413,1119,484,4025,1240,528,612,121,44,445,.7646048,.7546239,.1491985,.054254,.6337976,.2077994,.0898793,34.0046
16006,23649,1812,2642,13963,16605,9526,2881,1195,11507,3368,1314,1981,487,119,1330,.7339956,.7498108,.18433,.0450416,.6822316,.206331,.0855833,24.25482
16007,137961,11779,22929,75876,98805,56065,23097,11708,75323,31546,12872,19258,8449,1164,8953,.7600815,.8398971,.3684853,.0507654,.7389029,.3044046,.1543044,11.05833
16008,26184,1783,3047,16321,19368,11518,4352,1978,13858,5149,2108,2340,797,130,1300,.7291083,.7679685,.2615688,.0426649,.7057166,.2666503,.1211936,20.47032
16009,24820,2108,3516,14000,17516,9990,3834,1943,13053,5056,2055,3063,1222,112,1655,.7851044,.8711604,.347554,.0318544,.7135714,.2738571,.1387857,22.73228
16010,22900,1728,2711,12542,15253,8821,2648,1166,10810,3117,1230,1989,469,64,1225,.708912,.7336776,.1729989,.0236075,.7033169,.2111306,.0929676,27.19137
16011,20774,1732,2867,12491,15358,9294,3888,1819,11647,4957,1925,2353,1069,106,1401,.8088915,.8207185,.3728636,.0369724,.7440557,.3112641,.1456248,25.62748
16012,17668,1167,1785,10753,12538,6774,2080,779,8179,2450,833,1405,370,54,895,.7669237,.7871149,.2072829,.0302521,.6299638,.1934344,.0724449,26.42837
16013,13542,933,1350,8586,9936,5836,2117,827,6871,2465,891,1035,348,64,770,.8252947,.7666667,.2577778,.0474074,.6797112,.2465642,.0963196,25.01584
16014,22951,1802,2603,12979,15582,8204,2760,1247,10259,3333,1330,2055,573,83,1382,.7669256,.7894737,.2201306,.0318863,.632098,.2126512,.0960783,26.32076
16015,16932,1184,1807,10651,12458,7517,2414,1053,8797,2735,1101,1280,321,48,875,.7390203,.7083564,.1776425,.0265634,.7057554,.2266454,.098864,27.55848
16016,18635,1317,1935,11243,13178,7883,2814,1192,9425,3249,1285,1542,435,93,1028,.7805619,.7968992,.2248062,.048062,.7011474,.2502891,.1060215,27.17367
16017,48458,3531,6159,29705,35864,21533,9581,4104,26678,11524,4344,5145,1943,240,2735,.7745681,.8353629,.3154733,.0389674,.7248948,.3225383,.1381586,16.28235
16018,16238,1206,1716,9978,11694,7399,2627,1169,8646,3072,1247,1247,445,78,963,.7985075,.72669,.259324,.0454545,.7415314,.2632792,.1171577,31.28169
16019,15437,1240,1802,8760,10562,5878,1717,745,7325,2004,781,1447,287,36,900,.7258065,.8029967,.1592675,.0199778,.6710046,.1960046,.0850457,31.04806
16020,8612,555,877,5322,6199,3552,1057,420,4255,1236,463,703,179,43,372,.6702703,.8015963,.2041049,.0490308,.6674182,.1986095,.0789177,32.93215
16021,19576,1380,2419,11582,14001,8740,3294,1477,10591,3990,1561,1851,696,84,906,.6565217,.7651922,.2877222,.0347251,.7546192,.2844068,.1275255,25.4446
16022,21098,1521,2289,12535,14824,7836,2413,1100,9618,2777,1171,1782,364,71,1105,.7264957,.7785059,.1590214,.0310179,.6251296,.192501,.0877543,35.30238
16023,57122,4343,6644,33445,40089,23626,8497,3615,28755,9823,3881,5129,1326,266,3108,.7156343,.7719747,.1995786,.0400361,.7064135,.2540589,.1080879,16.61262
16024,18935,1447,2115,10977,13092,7098,1960,941,8631,2318,1007,1533,358,66,1071,.7401521,.7248227,.1692671,.0312057,.6466247,.1785552,.0857247,31.02596
16025,29513,1922,2959,17704,20663,13400,4808,2352,15747,5453,2467,2347,645,115,1390,.723205,.7931734,.217979,.0388645,.7568911,.271577,.1328513,19.33878
16026,9104,622,988,5489,6477,3494,1041,394,4193,1208,418,699,167,24,421,.6768489,.7074899,.1690283,.0242915,.6365458,.189652,.0717799,30.08716
16027,9794,1004,1763,5692,7455,3666,1395,787,5228,2173,839,1562,778,52,835,.8316733,.8859898,.4412932,.0294952,.6440619,.2450808,.1382642,38.68123
16028,18933,1608,2243,10252,12495,6748,1934,834,8529,2368,925,1781,434,91,1109,.6896766,.7940258,.1934909,.0405707,.658213,.1886461,.08135,36.91128
16029,46203,3216,5076,28013,33089,19802,7312,3230,23578,8641,3493,3776,1329,263,2346,.7294776,.7438928,.2618203,.0518125,.7068861,.2610217,.1153036,13.48825
16030,15629,951,1495,9941,11436,7443,3022,1358,8660,3456,1455,1217,434,97,713,.7497371,.8140468,.290301,.0648829,.7487174,.3039936,.136606,30.87306
16031,93745,8394,13315,50454,63769,34608,13055,7565,45358,17015,8271,10750,3960,706,6261,.7458899,.8073601,.2974089,.0530229,.6859317,.2587506,.1499386,16.79335
16032,13336,1063,1684,7819,9503,5458,2325,841,6791,2765,901,1333,440,60,870,.8184384,.7915677,.2612827,.0356295,.6980432,.2973526,.1075585,24.65155
16033,25488,1960,3079,15008,18087,10182,3459,1691,12628,4157,1802,2446,698,111,1420,.7244898,.7944137,.226697,.0360507,.6784382,.2304771,.1126732,28.36997
16034,19597,1410,1955,11896,13851,8378,2961,1371,9907,3367,1450,1529,406,79,1084,.7687943,.7820972,.2076726,.0404092,.7042704,.2489072,.1152488,22.51058
16035,13036,816,1203,8262,9465,5682,2197,845,6680,2536,906,998,339,61,680,.8333333,.8295927,.2817955,.0507066,.6877269,.2659162,.1022755,24.21585
16036,9401,552,811,5985,6796,4133,1337,626,4755,1547,654,622,210,28,442,.8007246,.7669544,.2589396,.0345253,.6905597,.2233918,.1045948,30.54566
16037,12119,852,1148,7655,8803,5468,1952,829,6316,2160,898,848,208,69,691,.8110329,.738676,.1811847,.0601045,.7143044,.2549967,.1082952,27.754
16038,14366,957,1419,8865,10284,6230,2202,883,7399,2493,948,1169,291,65,736,.76907,.8238196,.205074,.0458069,.7027637,.2483926,.0996052,23.99944
16039,11983,818,955,7767,8722,5123,1379,558,5814,1535,591,691,156,33,651,.7958435,.7235602,.1633508,.034555,.6595854,.177546,.0718424,35.54448
16040,17862,1251,1909,11030,12939,8038,2991,1237,9511,3483,1330,1473,492,93,952,.7609912,.7716082,.2577266,.0487166,.7287398,.2711695,.1121487,21.73956
16041,13833,960,1432,8309,9741,5811,2078,765,6958,2493,843,1147,415,78,777,.809375,.8009776,.2898045,.0544693,.6993622,.2500903,.0920688,31.34277
16042,21776,1901,2649,13302,15951,9062,3953,1457,11181,4792,1552,2119,839,95,1569,.8253551,.7999245,.3167233,.0358626,.6812509,.2971734,.1095324,22.05448
16043,16348,1189,1762,9843,11605,6848,1892,803,8153,2279,871,1305,387,68,901,.7577797,.7406356,.2196368,.0385925,.6957229,.1922178,.0815808,29.39954
16044,18890,1390,2415,11335,13750,7994,3197,1418,9865,4019,1521,1871,822,103,1082,.7784173,.7747412,.3403727,.0426501,.7052492,.2820468,.1250993,22.29238
16045,11114,836,1136,6809,7945,4080,1200,527,4968,1359,566,888,159,39,581,.6949761,.7816901,.1399648,.034331,.5992069,.1762373,.0773976,39.52844
16046,12246,849,1216,7646,8862,5376,1957,736,6297,2242,769,921,285,33,706,.8315666,.7574013,.234375,.0271382,.7031127,.2559508,.0962595,22.06594
16047,8908,535,845,5609,6454,3764,1265,608,4465,1465,635,701,200,27,411,.7682243,.8295858,.2366864,.0319527,.6710644,.2255304,.1083972,28.79081
16048,15429,1086,1658,9506,11164,6446,1977,904,7784,2366,1022,1338,389,118,835,.7688766,.8069964,.23462,.0711701,.678098,.2079739,.0950978,26.23517
16049,22503,1783,2536,12673,15209,7918,2365,1082,9865,2665,1143,1947,300,61,1297,.7274257,.7677445,.1182965,.0240536,.6247929,.1866172,.0853784,29.38599
16050,36425,2473,3871,22244,26115,15384,4805,2175,18383,5609,2329,2999,804,154,1790,.7238172,.7747352,.2076983,.039783,.6916022,.2160133,.0977792,17.34293
16051,16316,1019,2070,10219,12289,7574,3317,1893,9093,3835,1979,1519,518,86,693,.6800785,.7338164,.2502415,.0415459,.7411684,.3245915,.1852432,22.4459
16052,81717,7685,21509,42200,63709,36122,24462,16272,56489,38860,19820,20367,14398,3548,6682,.869486,.946906,.6693942,.1649542,.8559716,.5796682,.3855924,19.99626
16053,20401,1629,2548,11794,14342,7962,2566,1110,9608,3013,1256,1646,447,146,1256,.7710252,.6459969,.1754317,.0572998,.675089,.2175682,.0941157,29.25736
16054,12921,895,1338,8113,9451,5469,1480,589,6446,1784,641,977,304,52,668,.7463687,.7301943,.2272048,.038864,.6741033,.1824233,.0725995,29.22655
16055,21891,1690,2477,12795,15272,8687,2926,1096,10615,3579,1173,1928,653,77,1333,.7887574,.7783609,.2636254,.031086,.6789371,.2286831,.0856585,30.56399
16056,43106,3063,4931,26011,30942,17863,5918,2462,21576,6959,2687,3713,1041,225,2143,.6996409,.7529913,.2111134,.0456297,.6867479,.2275191,.0946523,20.11193
16057,169775,13224,23185,97230,120415,75462,33137,16196,94168,41122,17815,18706,7985,1619,10115,.7648972,.8068147,.3444037,.0698296,.7761185,.3408104,.1665741,12.05544
16058,12055,859,1303,7030,8333,4788,1590,597,5762,1827,621,974,237,24,593,.6903376,.7475058,.181888,.018419,.6810811,.2261735,.0849218,24.17433
16059,10313,615,951,6567,7518,4444,1371,514,5210,1512,543,766,141,29,396,.6439024,.8054679,.148265,.0304942,.6767169,.2087711,.0782701,30.30833
16060,12896,956,1309,7571,8880,4592,1675,703,5670,1927,744,1078,252,41,670,.7008368,.8235294,.1925134,.0313216,.6065249,.2212389,.0928543,35.55813
16061,12597,833,1094,7822,8916,5614,1665,668,6453,1836,694,839,171,26,610,.7322929,.7669104,.1563071,.023766,.7177193,.2128612,.0854002,28.43555
16062,22867,1593,2966,13845,16811,8938,3133,1529,11364,3986,1654,2426,853,125,1114,.6993095,.8179366,.2875927,.0421443,.645576,.2262911,.110437,26.4345
16063,29669,2329,4086,17340,21426,11028,3859,1818,14351,5184,1991,3323,1325,173,1853,.7956204,.8132648,.324278,.0423397,.6359861,.222549,.1048443,23.13907
16064,41652,2941,4783,25157,29940,18782,7864,3579,22499,9166,3844,3717,1302,265,2091,.7109827,.7771273,.2722141,.0554046,.7465914,.3125969,.1422666,16.48826
16065,13406,917,1454,7991,9445,5303,1840,812,6382,2136,866,1079,296,54,512,.5583424,.7420908,.2035763,.0371389,.6636215,.230259,.1016143,28.47826
16066,12329,963,1283,7458,8741,5128,1804,632,6096,2151,676,968,347,44,825,.8566978,.7544817,.2704599,.0342946,.6875838,.2418879,.0847412,30.18295
16067,11692,803,1091,7545,8636,4838,1481,615,5666,1607,634,828,126,19,588,.732254,.7589368,.1154904,.0174152,.6412194,.1962889,.0815109,33.7476
16068,9209,666,1000,5715,6715,3729,1057,374,4561,1290,411,832,233,37,511,.7672673,.832,.233,.037,.6524934,.1849519,.0654418,29.34956
16069,13413,859,1375,8572,9947,5906,2205,894,6945,2466,956,1039,261,62,549,.6391153,.7556363,.1898182,.0450909,.6889874,.2572328,.104293,26.92684
16070,40436,3097,5013,23058,28071,15311,6226,2727,18839,7253,2949,3528,1027,222,1995,.6441718,.7037702,.2048673,.0442849,.6640211,.2700147,.118267,18.8867
16071,16972,1277,1940,10337,12277,6661,2618,1211,8164,3120,1303,1503,502,92,998,.7815192,.7747422,.2587629,.0474227,.6443843,.253265,.117152,25.48653
16072,8371,593,965,5063,6028,3028,1112,429,3695,1289,453,667,177,24,430,.7251265,.6911917,.1834197,.0248705,.5980644,.2196326,.0847324,32.50097
16073,19063,1178,1871,12158,14029,8434,3140,1309,9846,3573,1422,1412,433,113,902,.7657046,.7546766,.231427,.0603955,.6936996,.2582662,.1076657,29.05191
16074,12721,1148,1515,7513,9028,5218,2054,854,6381,2565,904,1163,511,50,941,.8196864,.7676567,.3372937,.0330033,.6945295,.2733928,.1136696,37.33397
16075,24743,2045,3165,14104,17269,9479,3555,1682,12055,4412,1804,2576,857,122,1633,.798533,.8139021,.2707741,.0385466,.6720788,.2520562,.119257,30.35662
16076,11369,881,1062,7135,8197,4945,1761,690,5740,2022,735,795,261,45,717,.8138479,.7485875,.2457627,.0423729,.6930624,.2468115,.0967064,28.17487
16077,303170,22707,42129,177501,219630,139877,65673,34059,173634,80214,37720,33757,14541,3661,15840,.6975822,.801277,.3451542,.0868998,.788035,.3699867,.1918806,12.33764
16078,86561,6841,10550,49555,60105,33836,10759,4557,41657,12971,4876,7821,2212,319,4648,.6794328,.741327,.2096682,.030237,.6827969,.2171123,.0919584,16.85828
16079,19306,1656,2955,11179,14134,8182,2997,1650,10690,4251,1782,2508,1254,132,1288,.7777778,.848731,.4243655,.04467,.731908,.2680919,.1475982,26.39694
16080,6112,363,538,4054,4592,2736,792,339,3173,914,352,437,122,13,305,.8402204,.8122677,.2267658,.0241636,.674889,.1953626,.0836211,44.08453
16081,14118,945,1355,8909,10264,5813,2120,940,6842,2420,985,1029,300,45,700,.7407407,.7594096,.2214022,.0332103,.6524863,.2379616,.1055113,26.21568
16082,160022,11614,20969,89486,110455,66430,31308,16479,82677,37855,18267,16247,6547,1788,8177,.7040641,.7748104,.3122228,.0852687,.7423508,.3498648,.1841517,12.63291
16083,15043,1212,1514,8945,10459,6259,1994,857,7473,2319,915,1214,325,58,965,.7962046,.8018494,.2146631,.0383091,.6997205,.2229178,.0958077,34.80336
16084,30813,2999,5051,16182,21233,9557,4058,1942,13863,5996,2141,4306,1938,199,2594,.864955,.8525044,.3836864,.0393981,.5905945,.2507725,.1200099,31.16008
16085,72326,8797,23272,34027,57299,29120,17951,11531,51377,33310,13700,22257,15359,2169,8073,.9176992,.9563854,.6599777,.0932021,.855791,.5275517,.3388779,16.58405
16086,19533,1347,1907,11970,13877,7939,2481,1208,9354,2911,1311,1415,430,103,1045,.7757981,.7420031,.2254851,.0540115,.6632414,.2072682,.100919,26.66884
16087,8353,498,778,5420,6198,3497,975,386,4094,1154,436,597,179,50,371,.7449799,.7673522,.2300771,.0642674,.6452029,.1798893,.0712177,41.04346
16088,13858,1024,1579,8520,10099,5805,1825,783,7049,2254,837,1244,429,54,690,.6738281,.7878404,.2716909,.0341989,.681338,.2142019,.0919014,31.38127
16089,8626,603,848,5347,6195,3516,993,451,4115,1124,497,599,131,46,411,.681592,.7063679,.1544811,.0542453,.657565,.1857116,.0843464,35.03335
16090,40241,2841,4530,25096,29626,16312,5673,2487,19644,6506,2628,3332,833,141,2063,.7261528,.7355409,.1838852,.0311258,.6499841,.226052,.0990995,19.45827
16091,34878,2734,4132,19429,23561,15225,5342,2697,18520,6272,2892,3295,930,195,2049,.7494513,.7974346,.2250726,.0471926,.7836224,.2749498,.1388131,18.50745
16092,20141,1443,2159,12209,14368,8437,3112,1437,10059,3493,1521,1622,381,84,994,.6888427,.7512738,.1764706,.0389069,.6910476,.2548939,.1177001,25.6673
16093,8199,441,711,5484,6195,3459,901,427,4026,1079,453,567,178,26,299,.6780046,.7974684,.2503516,.0365682,.630744,.1642961,.0778629,38.67116
16094,45953,3980,5735,27344,33079,19516,8426,3442,23998,10135,3666,4482,1709,224,3099,.7786432,.781517,.2979948,.0390584,.7137215,.308148,.1258777,17.35229
16095,13010,1100,1629,7931,9560,5450,2268,841,6774,2734,886,1324,466,45,959,.8718182,.8127686,.2860651,.0276243,.6871769,.2859665,.1060396,24.5925
16096,21876,2377,4181,11698,15879,7197,2804,1553,10851,4640,1673,3654,1836,120,2021,.8502314,.8739536,.4391294,.0287013,.6152334,.2396991,.1327577,33.28993
16097,100884,7479,12808,58888,71696,42201,16917,8750,52124,20423,9364,9923,3506,614,5524,.7386014,.7747502,.2737352,.0479388,.7166316,.2872742,.1485872,17.94718
16098,9075,571,882,5799,6681,3891,1469,478,4617,1699,528,726,230,50,412,.7215412,.8231292,.260771,.0566893,.6709778,.2533195,.082428,24.79522
16099,16319,1154,1661,10319,11980,7286,2788,1056,8496,3196,1102,1210,408,46,911,.7894281,.7284768,.2456352,.0276942,.7060761,.2701812,.1023355,19.27852
17001,15654,1101,1824,9594,11418,6279,2587,1155,7613,3104,1219,1334,517,64,754,.684832,.7313597,.283443,.0350877,.6544715,.2696477,.1203877,31.12444
17002,8749,601,866,5467,6333,3263,1037,469,3927,1186,505,664,149,36,342,.5690516,.7667437,.1720554,.0415704,.5968539,.1896836,.0857875,29.06123
17003,18397,1717,2796,10386,13182,7162,2559,1364,9575,3524,1468,2413,965,104,1328,.773442,.8630186,.3451359,.037196,.6895821,.2463894,.1313306,23.91578
17004,6548,394,604,4320,4924,3030,1200,532,3491,1375,563,461,175,31,298,.7563452,.763245,.2897351,.0513245,.7013889,.2777778,.1231482,20.75124
17005,31343,2354,4059,18636,22695,13201,5659,2319,16212,6726,2469,3011,1067,150,1657,.7039083,.7418084,.2628726,.0369549,.7083601,.3036596,.1244366,15.32741
17006,15969,1148,1820,10186,12006,6460,2704,1081,7941,3275,1192,1481,571,111,776,.6759582,.8137363,.3137363,.060989,.6342038,.2654624,.1061261,32.56394
17007,11955,713,1165,7585,8750,5076,1699,743,5971,1987,803,895,288,60,496,.6956522,.7682403,.2472103,.0515021,.6692156,.2239947,.0979565,33.7564
17008,44782,3277,5009,26599,31608,19572,8580,3515,23481,9872,3692,3909,1292,177,2397,.7314617,.7803953,.2579357,.0353364,.7358171,.3225685,.1321478,16.41571
17009,3309,202,311,2199,2510,1476,595,263,1691,651,282,215,56,19,139,.6881188,.6913183,.1800643,.0610932,.6712142,.2705775,.1195998,28.72016
17010,5016,330,416,3439,3855,2059,687,257,2349,764,273,290,77,16,193,.5848485,.6971154,.1850962,.0384615,.5987206,.1997674,.074731,37.22452
17011,22304,1584,2251,13834,16085,8106,2631,1130,9751,3034,1185,1645,403,55,1088,.6868687,.7307863,.1790315,.0244336,.5859477,.1901836,.0816828,30.29949
17012,3678,207,302,2478,2780,1569,590,280,1805,684,315,236,94,35,158,.763285,.7814569,.3112583,.115894,.6331719,.2380952,.1129944,24.67134
17013,2599,165,168,1793,1961,1350,624,244,1466,674,254,116,50,10,139,.8424242,.6904762,.297619,.0595238,.7529281,.3480201,.1360848,26.70048
17014,9802,559,880,6380,7260,4490,1498,649,5155,1684,677,665,186,28,410,.7334526,.7556818,.2113636,.0318182,.7037618,.2347962,.1017241,24.5423
17015,12494,1108,1537,7935,9472,5672,2291,1024,6988,2811,1081,1316,520,57,831,.75,.8562134,.3383214,.0370852,.7148078,.2887208,.1290485,26.3664
17016,9370,594,954,5805,6759,3607,1161,545,4364,1337,591,757,176,46,396,.6666667,.793501,.1844864,.048218,.6213609,.2,.0938846,37.39005
17017,2554,151,219,1715,1934,1267,555,213,1446,633,221,179,78,8,121,.8013245,.8173516,.3561644,.0365297,.7387755,.3236152,.1241983,29.54128
17018,36824,2696,4340,22530,26870,15442,6714,2640,18894,8197,2773,3452,1483,133,1983,.7355341,.7953917,.3417051,.0306452,.6853973,.2980027,.1171771,21.5112
17019,37916,3065,5851,23215,29066,15120,7074,3649,20129,9824,4026,5009,2750,377,2415,.7879282,.856093,.4700051,.0644334,.6513031,.3047168,.1571829,28.15963
17020,4509,259,432,2936,3368,1999,804,316,2363,914,340,364,110,24,171,.6602316,.8425926,.2546296,.0555556,.6808583,.2738419,.1076294,24.95274
17021,20175,1458,1981,12795,14776,8761,3031,1341,10227,3435,1473,1466,404,132,975,.6687243,.7400303,.2039374,.066633,.6847206,.2368894,.1048066,21.83811
17022,9268,773,1132,5496,6628,3411,1081,477,4265,1378,527,854,297,50,616,.7968952,.7544169,.2623675,.0441696,.6206332,.1966885,.0867904,28.75053
17023,67640,8045,21314,32419,53733,26684,17058,11381,46979,30864,13672,20295,13806,2291,6952,.8641392,.9521911,.6477433,.107488,.8230976,.5261729,.3510596,18.49181
17024,4271,261,406,2790,3196,2022,875,346,2347,992,387,325,117,41,180,.6896552,.8004926,.2881773,.1009852,.7247312,.3136201,.1240143,28.58272
17025,3918,235,288,2710,2998,1644,529,190,1857,600,216,213,71,26,161,.6851064,.7395833,.2465278,.0902778,.6066421,.1952029,.0701107,37.1939
17026,26098,2636,5778,13416,19194,9833,5280,2809,15054,8431,3228,5221,3151,419,2136,.8103186,.9035999,.5453444,.0725164,.7329308,.3935599,.2093769,22.75249
17027,6640,389,551,4384,4935,3008,1181,510,3471,1348,545,463,167,35,282,.7249357,.8402904,.3030853,.0635209,.6861314,.2693887,.1163321,21.51849
17028,23825,1913,3334,12486,15820,8889,4535,1991,11221,5359,2121,2332,824,130,1120,.5854679,.6994601,.2471506,.0389922,.7119173,.3632068,.1594586,21.71626
17029,24315,2205,3548,13710,17258,10110,5012,2316,12816,6306,2512,2706,1294,196,1626,.737415,.7626832,.3647125,.0552424,.7374179,.3655726,.1689278,17.90485
17030,22062,1661,2696,13246,15942,8629,3046,1552,10823,3813,1704,2194,767,152,1150,.692354,.8137982,.2844956,.0563798,.6514419,.2299562,.1171675,27.09466
17031,29852,2978,7097,14061,21158,10433,3894,1776,15452,4900,1959,5019,1006,183,1195,.401276,.7072002,.14175,.0257855,.7419814,.2769362,.1263068,26.57348
17032,3726,271,386,2216,2602,1529,690,269,1839,766,285,310,76,16,200,.7380074,.8031088,.1968912,.0414508,.6899819,.3113718,.1213899,23.65984
17033,3995,320,401,2481,2882,1761,685,294,2041,781,306,280,96,12,227,.709375,.6982543,.2394015,.0299252,.7097945,.2760983,.1185006,23.85274
17034,6977,522,816,3750,4566,2603,1217,438,3122,1396,500,519,179,62,291,.5574713,.6360294,.2193628,.0759804,.6941333,.3245333,.1168,9.601068
17035,5138,347,597,2952,3549,1950,847,352,2336,968,381,386,121,29,233,.6714697,.6465662,.2026801,.0485762,.6605691,.2869241,.1192412,29.10921
17036,1845,118,216,1083,1299,796,327,120,939,365,124,143,38,4,92,.779661,.662037,.1759259,.0185185,.7349954,.3019391,.1108033,14.85196
17037,8764,510,713,5908,6621,3933,1350,546,4454,1494,591,521,144,45,355,.6960784,.7307153,.2019635,.0631136,.6657075,.2285037,.0924171,24.94552
17038,2514,186,225,1609,1834,1145,465,190,1303,493,190,158,28,0,136,.7311828,.7022222,.1244444,0,.7116221,.2889994,.1180858,18.38054
17039,7778,414,628,5266,5894,3580,1280,589,4089,1451,624,509,171,35,312,.7536232,.8105096,.272293,.0557325,.6798329,.2430687,.1118496,17.05644
17040,30531,2436,4090,18281,22371,13291,6237,3022,16687,7759,3270,3396,1522,248,1813,.7442529,.8303179,.3721271,.0606357,.727039,.3411739,.1653082,16.35713
17041,3814,279,428,2126,2554,1492,663,268,1777,766,302,285,103,34,192,.688172,.6658878,.2406542,.0794393,.7017874,.3118533,.1260583,12.83651
17042,2269,149,229,1438,1667,1065,530,229,1260,649,242,195,119,13,116,.7785235,.8515284,.5196506,.0567686,.740612,.3685675,.159249,21.22422
17043,11644,748,991,7060,8051,5147,1479,664,5950,1592,697,803,113,33,550,.7352941,.8102927,.1140262,.0332997,.7290368,.2094901,.094051,30.77149
17044,15207,1093,1317,9316,10633,6619,2094,1016,7681,2291,1047,1062,197,31,815,.7456542,.8063781,.1495824,.0235383,.7104981,.2247746,.1090597,25.75076
17045,5241,289,457,3477,3934,2542,755,338,2916,921,378,374,166,40,230,.7958478,.8183808,.3632385,.0875273,.73109,.2171412,.0972102,33.24397
17046,270269,18518,29143,162618,191761,144373,91782,54097,168282,103852,58132,23909,12070,4035,14298,.7721136,.8204029,.4141646,.1384552,.8878046,.5644025,.3326631,6.696932
17047,3435,242,386,1882,2268,1287,606,238,1562,681,250,275,75,12,156,.6446281,.7124352,.1943005,.0310881,.683847,.3219979,.1264612,16.22751
17048,8960,603,943,5613,6556,3732,1387,584,4441,1606,621,709,219,37,444,.7363184,.7518558,.2322375,.0392365,.6648851,.2471049,.1040442,21.60725
17049,4046,253,427,2573,3000,1911,887,369,2284,1090,403,373,203,34,219,.8656126,.8735363,.4754098,.0796253,.7427128,.3447338,.1434124,16.03711
17050,25682,1908,2808,15574,18382,10225,4154,1596,12347,4810,1719,2122,656,123,1381,.7237945,.755698,.2336182,.0438034,.656543,.2667266,.1024785,31.75528
17051,2472,128,220,1554,1774,1140,442,190,1304,499,196,164,57,6,89,.6953125,.7454545,.2590909,.0272727,.7335907,.2844273,.1222651,22.12479
17052,54809,3908,6945,31937,38882,23040,10090,5365,28245,11369,5595,5205,1279,230,2602,.6658137,.74946,.1841613,.0331174,.7214203,.3159345,.167987,20.05403
17053,4145,220,313,2864,3177,1897,623,283,2153,700,298,256,77,15,168,.7636364,.8178914,.2460064,.0479233,.6623603,.2175279,.0988128,25.72736
17054,8234,497,615,5419,6034,3430,1052,421,3887,1154,435,457,102,14,383,.7706237,.7430894,.1658537,.0227642,.6329581,.1941318,.0776896,30.87167
17055,3478,271,363,2147,2510,1476,592,222,1747,703,233,271,111,11,203,.7490775,.7465565,.3057851,.030303,.6874709,.2757336,.1034001,18.31832
17056,35108,3137,7587,18732,26319,14316,7387,3815,21037,11135,4388,6721,3748,573,2388,.7612368,.8858574,.4940029,.0755239,.7642537,.3943519,.2036622,25.81915
17057,26855,2225,3939,16178,20117,11545,5326,2521,14809,6860,2713,3264,1534,192,1694,.7613483,.8286367,.389439,.0487433,.7136235,.3292125,.1558289,18.38799
17058,13522,936,1516,8852,10368,5564,2116,991,6832,2688,1094,1268,572,103,710,.758547,.8364116,.3773087,.067942,.6285585,.239042,.1119521,20.53346
17059,12787,886,1339,8365,9704,5568,1626,784,6692,1887,849,1124,261,65,638,.7200903,.8394324,.1949216,.0485437,.6656306,.1943814,.0937238,31.6092
17060,4788,323,536,2950,3486,2093,971,423,2485,1159,464,392,188,41,229,.7089784,.7313433,.3507463,.0764925,.7094916,.3291526,.1433898,23.69086
17061,21618,1541,2202,13131,15333,8986,2987,1308,10634,3390,1387,1648,403,79,1125,.7300454,.7484105,.1830154,.0358765,.6843348,.227477,.0996116,23.50474
17062,8117,682,860,5023,5883,3576,1415,702,4308,1642,754,732,227,52,530,.7771261,.8511628,.2639535,.0604651,.7119251,.2817042,.1397571,25.8754
17063,42281,3074,4584,26191,30775,16885,7388,2750,20364,8484,2916,3479,1096,166,2167,.7049447,.7589442,.2390925,.0362129,.6446871,.2820816,.1049979,26.58186
17064,6419,421,584,4242,4826,2858,977,458,3306,1071,487,448,94,29,295,.7007126,.7671233,.1609589,.0496575,.6737388,.2303159,.1079679,31.64772
17065,3454,235,416,1955,2371,1494,583,259,1810,648,268,316,65,9,142,.6042553,.7596154,.15625,.0216346,.7641944,.2982097,.1324808,12.78578
17066,11211,828,1154,6794,7948,4349,1185,567,5307,1385,629,958,200,62,639,.7717391,.830156,.1733102,.0537262,.6401237,.1744186,.083456,37.50697
17067,18967,1260,2068,11664,13732,7806,3210,1214,9491,3700,1284,1685,490,70,883,.7007936,.8147969,.2369439,.0338491,.6692387,.2752058,.1040809,28.55608
17068,4498,312,462,2881,3343,1977,808,342,2354,970,387,377,162,45,233,.7467949,.8160173,.3506494,.0974026,.68622,.2804582,.1187088,28.32003
17069,6689,437,608,4485,5093,2953,1122,479,3387,1287,533,434,165,54,295,.6750572,.7138158,.2713816,.0888158,.6584169,.2501672,.1068004,26.55951
17070,15319,1085,1538,9414,10952,6471,1812,796,7734,2070,867,1263,258,71,759,.6995392,.8211964,.1677503,.0461638,.6873805,.1924793,.0845549,29.34033
17071,5959,318,516,3969,4485,2627,917,413,2990,1053,441,363,136,28,241,.7578616,.7034883,.2635659,.0542636,.6618795,.2310406,.1040564,29.11084
17072,5971,405,529,3900,4429,2817,894,369,3241,1040,399,424,146,30,294,.7259259,.8015123,.2759925,.0567108,.7223077,.2292308,.0946154,24.43787
17073,8065,567,803,5229,6032,3919,2047,835,4466,2262,876,547,215,41,348,.6137566,.6811955,.2677459,.0510585,.7494741,.3914706,.1596864,19.02572
17074,7406,423,589,4879,5468,3328,1092,403,3783,1276,435,455,184,32,335,.7919621,.7724957,.3123939,.0543294,.682107,.2238164,.0825989,24.79301
17075,14782,1035,1796,8764,10560,6361,2290,1223,7789,2757,1359,1428,467,136,706,.6821256,.7951002,.2600223,.0757238,.7258101,.2612962,.1395482,27.87555
17076,10275,760,1309,6443,7752,4638,2107,975,5697,2566,1033,1059,459,58,553,.7276316,.8090145,.3506494,.0443086,.719851,.3270216,.151327,18.07259
17077,4105,253,359,2612,2971,1757,787,333,2039,886,353,282,99,20,193,.7628459,.7855153,.275766,.0557103,.6726646,.3013017,.1274885,21.49248
17078,64983,4990,8496,38756,47252,27665,12754,5100,33936,15058,5417,6271,2304,317,3470,.6953908,.738112,.2711864,.0373117,.7138249,.3290845,.1315925,17.55693
17079,7569,417,671,5187,5858,3670,1425,600,4211,1713,634,541,288,34,345,.8273382,.8062593,.4292101,.0506706,.7075381,.2747253,.1156738,32.48005
17080,11900,833,1442,7446,8888,5338,2200,1042,6505,2725,1123,1167,525,81,671,.8055222,.8092927,.3640777,.056172,.716895,.2954606,.1399409,17.02342
17081,63505,8384,24036,25658,49694,21944,12799,8117,42940,24174,10350,20996,11375,2233,5317,.6341842,.8735231,.4732485,.0929023,.8552498,.4988308,.3163536,22.92177
17082,7006,509,689,4344,5033,2910,1074,462,3441,1228,496,531,154,34,375,.7367387,.7706822,.2235123,.0493469,.6698895,.2472376,.1063536,20.41561
17083,4516,248,362,3054,3416,1931,862,392,2228,964,411,297,102,19,192,.7741935,.820442,.281768,.0524862,.6322855,.2822528,.1283562,22.75991
17084,8868,520,841,5859,6700,3949,1641,618,4608,1897,684,659,256,66,385,.7403846,.783591,.3043995,.078478,.6740058,.2800819,.1054787,18.27264
17085,48905,4019,7096,28396,35492,21681,9631,4424,27351,11785,4835,5670,2154,411,2730,.6792734,.7990417,.3035513,.05792,.763523,.3391675,.1557966,15.38182
17086,5782,399,575,3392,3967,2528,1062,471,2962,1171,514,434,109,43,315,.7894737,.7547826,.1895652,.0747826,.745283,.3130896,.1388561,19.45119
17087,366531,25666,52604,210975,263579,161361,79647,39190,201854,95740,42905,40493,16093,3715,16017,.6240551,.7697704,.3059273,.070622,.7648347,.3775187,.1857566,13.85998
17088,17071,1345,2582,9157,11739,6493,2843,1216,8311,3415,1344,1818,572,128,820,.6096655,.7041053,.2215337,.049574,.709075,.3104729,.1327946,12.50393
17089,154916,11053,19938,92533,112471,72430,33864,18402,88791,39882,20004,16361,6018,1602,7292,.6597304,.8205938,.3018357,.0803491,.7827478,.3659667,.1988696,15.60994
17090,3544,255,343,2088,2431,1406,586,244,1709,655,261,303,69,17,192,.7529412,.8833819,.2011662,.0495627,.6733717,.2806513,.1168582,32.68551
17091,7759,699,933,4570,5503,3298,1277,560,4016,1497,594,718,220,34,539,.7711016,.7695606,.2357985,.0364416,.721663,.2794311,.1225383,19.22296
17092,5947,333,498,4064,4562,2694,903,357,3093,1053,402,399,150,45,267,.8018018,.8012048,.3012048,.0903614,.6628937,.2221949,.0878445,31.52202
17093,5694,326,458,3874,4332,2806,1246,545,3141,1395,592,335,149,47,249,.7638037,.731441,.3253275,.1026201,.7243159,.3216314,.1406815,23.00398
17094,2339,169,259,1297,1556,873,411,180,1046,467,189,173,56,9,104,.6153846,.6679537,.2162162,.034749,.6730918,.3168851,.1387818,17.95238
17095,4736,271,534,2747,3281,2091,758,277,2528,879,298,437,121,21,141,.5202952,.818352,.2265918,.0393258,.7611941,.2759374,.1008373,14.28571
17096,24928,1629,2537,15442,17979,10557,3684,1377,12518,4223,1481,1961,539,104,1150,.7059546,.7729602,.2124557,.0409933,.683655,.2385701,.0891724,18.2844
17097,8451,877,1397,4620,6017,3425,1762,795,4614,2327,883,1189,565,88,683,.7787913,.8511095,.4044381,.0629921,.741342,.3813853,.1720779,17.96438
17098,4165,251,402,2614,3016,1635,669,241,1972,780,254,337,111,13,187,.7450199,.8383085,.2761194,.0323383,.6254782,.2559296,.0921959,23.3672
17099,6867,487,589,4341,4930,2993,938,420,3473,1039,440,480,101,20,373,.7659138,.8149406,.1714771,.0339559,.6894725,.2160792,.0967519,31.89349
17100,2045,114,203,1238,1441,881,377,147,1052,428,169,171,51,22,81,.7105263,.8423645,.2512315,.1083744,.7116317,.3045234,.1187399,23.16583
17101,8543,574,712,5570,6282,3304,927,439,3864,1111,481,560,184,42,460,.8013937,.7865168,.258427,.0589888,.5931777,.1664273,.0788151,37.38453
17102,3041,225,308,1703,2011,1120,504,236,1327,594,268,207,90,32,187,.8311111,.6720779,.2922078,.1038961,.6576629,.2959483,.138579,28.43243
17103,12128,688,1123,7723,8846,4945,1863,793,5691,2090,842,746,227,49,429,.6235465,.6642921,.2021371,.0436331,.6402952,.2412275,.1026803,28.27554
17104,4600,280,430,3113,3543,1884,630,263,2175,709,280,291,79,17,175,.625,.6767442,.1837209,.0395349,.605204,.2023771,.0844844,32.41187
17105,172335,12768,23242,97999,121241,60579,21655,8782,77973,27514,10146,17394,5859,1364,8193,.6416823,.7483866,.2520867,.0586869,.6181594,.2209716,.0896132,16.65832
18001,15233,1123,1590,9291,10881,3213,1151,497,4237,1451,538,1024,300,41,664,.5912734,.6440251,.1886792,.0257862,.3458185,.1238833,.0534926,59.4622
18002,14128,932,1449,8779,10228,3382,1087,443,4206,1227,482,824,140,39,513,.5504292,.5686681,.0966184,.0269151,.3852375,.1238182,.0504613,53.51461
18003,12567,870,1379,7393,8772,3722,1193,537,4641,1360,563,919,167,26,553,.6356322,.6664249,.1211023,.0188542,.5034492,.1613689,.0726363,33.73228
18004,8798,577,866,5521,6387,2950,886,424,3515,1010,436,565,124,12,359,.6221837,.6524249,.1431871,.0138568,.5343235,.1604782,.0767977,38.96831
18005,34009,2265,3769,20684,24453,9103,3356,1662,11529,3762,1760,2426,406,98,1173,.5178808,.643672,.1077209,.0260016,.4400986,.162251,.080352,47.23883
18006,10025,759,1161,5908,7069,2101,730,377,2860,869,398,759,139,21,361,.4756258,.6537468,.1197244,.0180879,.3556195,.1235613,.0638118,57.90098
18007,34330,2534,3921,19319,23240,6992,2521,1256,9039,2915,1363,2047,394,107,1346,.531176,.5220607,.1004846,.027289,.3619235,.1304933,.0650137,64.76141
18008,45842,3236,5503,25095,30598,16389,5971,2953,20529,7026,3161,4140,1055,208,2148,.6637824,.7523169,.1917136,.0377976,.6530783,.2379358,.1176728,14.63337
18009,19405,1257,2073,11628,13701,6235,2049,1066,7647,2338,1115,1412,289,49,735,.5847256,.6811385,.1394115,.0236372,.5362057,.1762126,.0916753,38.92332
18010,55513,3745,6459,33759,40218,19903,7509,3318,24899,9023,3694,4996,1514,376,2294,.6125501,.7734944,.2344016,.0582133,.5895613,.2224296,.0982849,27.80985
18011,25066,1992,3179,14648,17827,8139,3414,1843,10400,4295,2011,2261,881,168,1349,.6772088,.7112299,.2771312,.0528468,.555639,.2330694,.1258192,37.28769
18012,7738,538,789,4627,5416,2021,479,250,2553,602,266,532,123,16,379,.704461,.6742712,.1558935,.0202788,.4367841,.1035228,.0540307,37.7459
18013,17004,1543,2204,8776,10980,3248,1450,785,4412,1829,853,1164,379,68,840,.544394,.5281307,.1719601,.030853,.3701003,.1652233,.0894485,74.5382
18014,16861,1240,1878,9892,11770,4162,1030,562,5541,1206,592,1379,176,30,694,.5596774,.7342918,.0937167,.0159744,.420744,.1041245,.0568136,49.98285
18015,43346,3579,5068,22177,27245,11749,3027,1284,15071,3457,1358,3322,430,74,2097,.5859178,.6554854,.0848461,.0146014,.5297831,.1364928,.0578978,29.1564
18016,11064,862,1210,6504,7714,2249,498,203,2959,585,220,710,87,17,485,.562645,.5867769,.0719008,.0140496,.3457872,.0765683,.0312116,57.94942
18017,13473,877,1399,8625,10024,4273,1354,652,5210,1510,688,937,156,36,551,.6282782,.6697641,.1115082,.0257327,.4954203,.1569855,.0755942,42.31292
18018,30031,3171,6757,16883,23640,10102,5118,3064,16137,8737,3551,6035,3619,487,2547,.8032166,.8931478,.5355927,.0720734,.5983534,.3031452,.1814843,35.19131
18019,83317,6521,10462,47773,58235,26585,9456,4698,34443,11915,5149,7858,2459,451,4168,.6391658,.7510992,.2350411,.0431084,.5564859,.1979361,.0983401,15.48392
18020,5487,314,531,3457,3988,1815,455,160,2250,510,167,435,55,7,195,.6210191,.819209,.1035782,.0131827,.5250217,.131617,.0462829,38.15696
18021,9270,641,1007,5517,6524,2567,808,418,3199,973,482,632,165,64,335,.5226209,.6276067,.163853,.0635551,.4652891,.1464564,.0757658,39.51364
18022,25060,1886,3255,13753,17008,5223,1605,737,7518,2293,838,2295,688,101,1029,.5455992,.7050691,.2113671,.0310292,.3797717,.1167018,.0535883,54.01148
18023,14818,1067,1536,8665,10201,2879,967,500,3628,1043,516,749,76,16,483,.4526711,.4876302,.0494792,.0104167,.3322562,.1115984,.0577034,64.56979
18024,66878,6140,14100,32876,46976,19877,7472,2864,30113,9221,3076,10236,1749,212,2797,.4555375,.7259575,.1240426,.0150355,.6046052,.2272783,.0871152,38.88912
18025,28322,1992,3059,16521,19580,9234,3571,1592,11170,4107,1687,1936,536,95,1070,.5371486,.6328866,.1752207,.0310559,.558925,.2161491,.0963622,34.59031
18026,22752,1896,2838,11718,14556,3232,1364,851,4445,1626,918,1213,262,67,715,.3771097,.4274137,.0923185,.0236082,.275815,.1164021,.0726233,75.94464
18027,9321,593,976,5588,6564,1704,521,263,2288,684,278,584,163,15,404,.6812816,.5983607,.1670082,.0153689,.3049392,.0932355,.0470651,67.35445
18028,9207,651,978,5776,6754,2622,682,343,3251,777,368,629,95,25,363,.5576037,.6431493,.097137,.0255624,.4539474,.1180748,.0593837,49.51568
18029,7289,512,787,4551,5338,1322,542,305,1699,603,308,377,61,3,253,.4941406,.4790343,.0775095,.0038119,.2904856,.1190947,.0670182,62.92835
18030,85949,6504,11040,48965,60005,30006,11782,5396,38495,14187,5936,8489,2405,540,4113,.6323801,.7689312,.2178442,.048913,.6128051,.2406209,.1102012,28.24276
18031,9962,851,1066,5772,6838,2050,629,307,2623,685,319,573,56,12,476,.559342,.5375234,.0525328,.011257,.3551629,.1089744,.0531878,61.04983
18032,6908,477,783,3742,4525,1171,478,264,1618,575,298,447,97,34,258,.5408805,.5708812,.1238825,.0434227,.3129342,.1277392,.0705505,60.45296
18033,14495,1088,1579,8301,9880,3185,977,542,4142,1143,583,957,166,41,526,.4834559,.6060798,.1051298,.0259658,.3836887,.1176967,.0652933,56.41235
18034,204165,16432,37493,115055,152548,82357,49862,29424,113473,68909,34202,31116,19047,4778,11895,.7238924,.8299149,.5080149,.1274371,.7158055,.4333753,.2557386,23.97029
18035,12323,824,1308,7326,8634,2944,750,458,3800,947,514,856,197,56,529,.6419903,.6544343,.1506116,.0428135,.4018564,.1023751,.0625171,50.33119
18036,48764,3486,5742,26961,32703,10750,4267,1623,13974,5171,1775,3224,904,152,1791,.5137694,.5614768,.1574364,.0264716,.3987241,.1582657,.0601981,60.36939
18037,41830,2849,5132,25064,30196,16037,7698,4517,19942,9342,4798,3905,1644,281,1756,.6163566,.7609119,.320343,.0547545,.639842,.3071337,.1802186,21.64688
18038,8971,692,943,5495,6438,2481,814,361,3026,1002,384,545,188,23,367,.5303468,.5779427,.1993637,.0243902,.4515014,.1481347,.0656961,45.9027
18039,4842,395,531,2761,3292,1192,365,152,1474,413,152,282,48,0,264,.6683545,.5310735,.0903955,0,.4317276,.1321985,.0550525,36.27576
18040,10853,757,1221,6741,7962,3000,1009,485,3728,1151,515,728,142,30,394,.5204756,.5962326,.1162981,.02457,.4450378,.1496811,.0719478,42.18639
18041,13308,984,1413,7630,9043,3741,1012,424,4577,1161,478,836,149,54,556,.5650406,.591649,.1054494,.0382166,.4903014,.1326343,.0555701,31.04173
18042,34049,2319,3442,21686,25128,10836,3755,1713,13312,4442,1865,2476,687,152,1589,.6852092,.7193492,.1995933,.0441604,.4996772,.1731532,.0789911,34.09996
18043,20854,1543,2321,12203,14524,4543,1336,687,5999,1609,739,1456,273,52,804,.5210629,.6273158,.1176217,.0224041,.3722855,.1094813,.0562976,54.06124
18044,11043,750,1143,6918,8061,2461,754,272,3136,860,289,675,106,17,395,.5266666,.5905512,.0927384,.0148731,.3557386,.108991,.0393177,42.72222
18045,39132,2824,4267,22402,26669,12795,4375,2036,15866,5031,2104,3071,656,68,1865,.6604108,.7197094,.153738,.0159363,.5711544,.1952951,.0908847,37.07141
18046,7742,607,885,4253,5138,2433,647,270,3082,767,275,649,120,5,431,.7100495,.7333333,.1355932,.0056497,.5720668,.1521279,.0634846,47.78354
18047,88917,13247,22345,39986,62331,26602,9743,4351,40638,12278,4912,14036,2535,561,3473,.2621726,.6281494,.1134482,.0251063,.6652828,.2436603,.1088131,32.9371
18048,41889,3053,5076,22992,28068,8777,3030,1321,11571,3691,1448,2794,661,127,1454,.4762529,.5504334,.1302207,.0250197,.3817415,.131785,.0574548,54.66656
18049,15166,986,1587,9271,10858,4345,1359,681,5365,1572,762,1020,213,81,653,.6622718,.6427221,.1342155,.0510397,.4686657,.1465861,.0734549,33.5351
18050,15402,1193,1688,9123,10811,3391,1090,585,4366,1252,619,975,162,34,557,.4668902,.5776066,.0959716,.0201422,.3716979,.1194782,.0641236,52.71876
18051,40849,2957,4965,23811,28776,13626,5300,2429,17046,6269,2557,3420,969,128,1816,.6141359,.6888217,.1951662,.0257805,.5722565,.2225862,.1020117,33.55639
18052,12740,890,1305,7776,9081,3960,1194,578,4844,1364,593,884,170,15,580,.6516854,.6773946,.1302682,.0114943,.5092593,.1535494,.0743313,39.37838
18053,6065,419,637,3830,4467,2038,677,289,2481,736,313,443,59,24,230,.548926,.6954474,.0926217,.0376766,.5321149,.1767624,.0754569,44.43353
18054,46174,3171,5278,27410,32688,13621,4535,2057,17100,5258,2197,3479,723,140,1836,.5789971,.6591512,.1369837,.0265252,.4969354,.1654506,.0750456,37.2474
18055,11996,894,1395,6693,8088,1690,560,281,2313,646,303,623,86,22,340,.3803132,.446595,.0616487,.0157706,.2525026,.0836695,.0419842,72.31853
18056,685004,49882,88120,406868,494988,258907,119696,62343,322866,144226,68423,63959,24530,6080,33448,.6705425,.7258171,.2783704,.0689968,.6363415,.2941888,.1532266,19.39021
18057,26146,2021,4267,14032,18299,8377,4012,2428,11672,5589,2868,3295,1577,440,1340,.6630381,.7722053,.3695805,.1031169,.5969926,.2859179,.1730331,37.88535
18058,24432,1702,2750,13944,16694,5969,2064,1026,7680,2502,1125,1711,438,99,870,.5111634,.6221818,.1592727,.036,.4280694,.1480207,.07358,60.01725
18059,137058,10012,17588,78036,95624,46036,18848,9490,59630,23486,10654,13594,4638,1164,6311,.6303436,.7729133,.2637025,.0661815,.5899329,.2415296,.1216105,15.95138
18060,17940,1498,2299,9283,11582,3356,1293,562,4592,1614,602,1236,321,40,734,.4899867,.5376251,.1396259,.0173989,.3615211,.1392869,.0605408,76.2463
18061,30239,2221,3422,16552,19974,5963,2182,1215,7676,2633,1282,1713,451,67,973,.438091,.5005845,.1317943,.0195792,.3602586,.131827,.073405,72.51512
18062,11922,888,1244,7232,8476,3176,852,365,4033,1060,386,857,208,21,541,.6092342,.6889067,.1672026,.016881,.4391593,.1178097,.0504701,40.13038
18063,38982,3030,4740,21732,26472,9233,3310,1464,11886,3812,1603,2653,502,139,1495,.4933994,.5597047,.1059072,.0293249,.4248573,.15231,.0673661,59.34849
18064,14121,1053,1586,7982,9568,2876,847,437,3842,1030,472,966,183,35,481,.4567901,.6090794,.1153846,.0220681,.3603107,.1061138,.0547482,66.37753
18065,7754,589,800,4544,5344,1570,569,257,1997,678,270,427,109,13,334,.5670628,.53375,.13625,.01625,.3455106,.1252201,.0565581,69.74606
18066,14882,1179,1957,7448,9405,2280,966,523,3199,1148,546,919,182,23,555,.4707379,.4695963,.0929995,.0117527,.3061225,.1296992,.0702202,81.09801
18067,30687,2239,3562,16618,20180,6292,2062,1118,8008,2479,1185,1716,417,67,1295,.5783832,.4817518,.1170691,.0188097,.3786256,.1240823,.0672764,62.05283
18068,14545,1072,1666,7805,9471,2576,792,417,3554,1004,468,978,212,51,568,.5298507,.5870348,.1272509,.0306122,.3300448,.1014734,.0534273,51.95862
18069,19053,1323,2026,11159,13185,4125,1123,528,5154,1274,555,1029,151,27,669,.5056689,.5078973,.0745311,.0133268,.3696568,.1006363,.0473161,51.01981
18070,9219,603,957,5723,6680,2912,785,307,3647,947,321,735,162,14,387,.641791,.7680251,.169279,.014629,.5088241,.1371658,.0536432,45.35096
18071,24138,1818,2751,14495,17246,6533,2224,962,8165,2577,1028,1632,353,66,1028,.5654566,.5932388,.128317,.0239913,.4507071,.1534322,.0663677,45.63643
18072,6490,378,792,4373,5165,2365,704,278,2769,848,293,404,144,15,233,.6164021,.510101,.1818182,.0189394,.5408186,.1609879,.0635719,37.01493
18073,61310,4124,6605,38193,44798,24017,10258,4374,29146,11956,4665,5129,1698,291,2845,.6898642,.7765329,.257078,.0440575,.6288325,.2685832,.1145236,27.44904
18074,15634,1399,1752,8145,9897,2342,714,425,2960,769,439,618,55,14,717,.5125089,.3527397,.0313927,.0079909,.2875384,.0876611,.0521793,78.9374
18075,10090,632,982,6149,7131,2896,783,343,3589,898,377,693,115,34,406,.6424051,.7057027,.1171079,.0346232,.4709709,.1273378,.0557814,42.69223
18076,53352,6587,14042,26152,40194,14356,7820,4656,26489,15367,5474,12133,7547,818,5251,.7971762,.8640507,.5374591,.0582538,.5489447,.2990211,.1780361,45.36092
18077,13515,1033,1617,6841,8458,2058,740,377,2828,904,399,770,164,22,469,.4540174,.4761905,.1014224,.0136054,.3008332,.1081713,.0551089,76.66171
18078,17910,1548,2133,9606,11739,4310,1294,639,5863,1587,668,1553,293,29,954,.6162791,.7280825,.1373652,.0135959,.4486779,.1347075,.0665209,46.29854
18079,25637,1702,2690,16184,18874,9132,3087,1358,11139,3626,1453,2007,539,95,1124,.6603996,.7460967,.2003717,.035316,.564261,.1907439,.08391,29.60801
18080,13925,1159,1799,6874,8673,2369,763,404,3290,965,469,921,202,65,561,.484038,.5119511,.1122846,.0361312,.3446319,.110998,.0587722,70.12448
18081,17765,1163,1942,10708,12650,5266,1970,1038,6548,2392,1136,1282,422,98,725,.6233878,.6601442,.2173018,.0504634,.4917818,.1839746,.0969369,36.65729
18082,22854,1627,2936,11623,14559,7461,2762,1418,9707,3297,1600,2246,535,182,974,.5986478,.7649864,.1822207,.0619891,.6419169,.2376323,.1219995,29.52361
18083,5117,485,645,2761,3406,879,250,115,1207,305,139,328,55,24,179,.3690722,.5085272,.0852713,.0372093,.3183629,.0905469,.0416516,62.82195
18084,19011,1191,2060,11520,13580,6020,2105,1059,7338,2397,1123,1318,292,64,610,.5121747,.6398059,.1417476,.031068,.5225694,.1827257,.0919271,36.91151
18085,9484,652,1018,5730,6748,1894,604,298,2449,686,311,555,82,13,394,.6042945,.5451866,.0805501,.0127701,.330541,.1054101,.052007,58.16728
18086,12353,913,1331,7454,8785,2417,683,390,3254,774,398,837,91,8,569,.6232201,.6288505,.0683696,.0060105,.3242554,.0916287,.0523209,63.26203
18087,20046,1402,2307,11405,13712,5343,1934,916,6867,2232,955,1524,298,39,804,.5734665,.6605982,.1291721,.0169051,.4684787,.1695748,.0803156,44.02848
18088,12103,981,1575,6680,8255,2036,845,422,2868,979,431,832,134,9,390,.3975535,.528254,.0850794,.0057143,.3047904,.126497,.0631737,64.29308
18089,32238,2348,3704,18947,22651,8485,2589,1226,10769,2906,1280,2284,317,54,1145,.4876491,.6166307,.0855832,.0145788,.4478281,.1366443,.0647068,44.42717
18090,27584,2310,3466,14802,18268,8286,2978,1478,10957,3439,1569,2671,461,91,1546,.6692641,.770629,.1330063,.026255,.5597892,.201189,.0998514,38.92592
18091,7157,504,786,4329,5115,1819,494,274,2259,585,283,440,91,9,264,.5238096,.5597965,.1157761,.0114504,.4201894,.1141141,.0632941,46.45002
18092,21765,1451,2325,12863,15188,5667,1430,657,7120,1643,700,1453,213,43,764,.5265334,.6249462,.0916129,.0184946,.440566,.1111716,.0510767,50.33738
18093,27795,1904,3278,15518,18796,10757,5057,2538,12722,5580,2610,1965,523,72,1224,.6428571,.5994509,.1595485,.0219646,.693195,.3258796,.163552,27.52268
18094,8924,582,858,5460,6318,2272,700,384,2759,788,409,487,88,25,358,.6151203,.5675991,.1025641,.0291375,.4161172,.1282051,.0703297,39.46271
18095,5709,412,629,3237,3866,949,398,222,1270,481,232,321,83,10,211,.5121359,.5103338,.1319555,.0158983,.2931727,.1229534,.068582,74.85141
18096,10989,828,1249,6238,7487,2960,689,373,3743,805,395,783,116,22,487,.5881643,.6269015,.0928743,.0176141,.4745111,.1104521,.0597948,32.24437
18097,33763,2578,4144,17943,22087,6688,2561,1085,8966,3021,1225,2278,460,140,1203,.4666408,.5497105,.1110039,.0337838,.3727359,.1427298,.0604693,61.45668
18098,81123,5859,10142,43648,53790,16708,5584,2702,22842,6881,2880,6134,1297,178,3160,.5393412,.6048117,.127884,.0175508,.3827896,.1279325,.0619043,59.7947
18099,11101,855,1294,5973,7267,2032,624,329,2752,721,357,720,97,28,437,.5111111,.5564142,.0749614,.0216383,.3401976,.1044701,.0550812,58.79593
18100,45803,3412,5373,27175,32548,12085,4198,1940,15359,5024,2042,3274,826,102,1940,.5685815,.609343,.1537316,.0189838,.4447102,.1544802,.0713891,58.54304
18101,2265,143,212,1424,1636,579,198,94,730,239,96,151,41,2,93,.6503497,.7122642,.1933962,.009434,.4066011,.1390449,.0660112,54.48392
18102,13973,1058,1551,8008,9559,2753,848,498,3606,1061,551,853,213,53,602,.5689981,.5499678,.1373308,.0341715,.3437812,.1058941,.0621878,67.84291
18103,19049,2407,4982,9205,14187,4691,2578,1559,8984,5106,1877,4293,2528,318,1954,.8117989,.8617021,.5074267,.0638298,.5096143,.2800652,.1693645,51.68185
18104,13708,918,1437,8384,9821,3139,1108,505,4009,1289,545,870,181,40,579,.6307189,.605428,.1259568,.0278358,.3744036,.1321565,.0602338,64.56302
18105,21813,1688,3085,12203,15288,6730,2608,1416,9017,3623,1576,2287,1015,160,1154,.6836493,.741329,.3290114,.0518639,.5515037,.2137179,.116037,33.79505
18106,23328,1942,2669,13909,16578,7660,2710,1567,9323,3013,1641,1663,303,74,975,.5020598,.6230798,.1135257,.0277257,.5507225,.1948379,.1126609,32.51111
18107,14673,1048,1688,8586,10274,4276,1389,652,5443,1621,687,1167,232,35,525,.5009542,.6913507,.1374408,.0207346,.49802,.161775,.0759376,46.60023
18108,5929,417,648,3455,4103,1371,336,185,1757,382,191,386,46,6,233,.558753,.595679,.0709877,.0092593,.3968162,.0972504,.0535456,37.65311
18109,21178,1674,2641,12533,15174,5531,2050,1030,7443,2680,1126,1912,630,96,1068,.6379929,.7239682,.238546,.0363499,.4413149,.1635682,.082183,36.67704
18110,11874,792,1284,7090,8374,2927,940,412,3685,1224,463,758,284,51,513,.6477273,.5903427,.2211838,.0397196,.412835,.1325811,.05811,54.3392
18111,9384,601,831,5956,6787,2917,1098,558,3480,1261,574,563,163,16,426,.7088186,.677497,.1961492,.0192539,.4897582,.1843519,.093687,55.84641
18112,6253,421,660,3699,4359,1821,424,196,2252,479,201,431,55,5,260,.6175772,.6530303,.0833333,.0075758,.4922952,.1146256,.0529873,34.27419
18113,17821,2748,3270,8864,12134,5000,1614,590,6533,1905,643,1533,291,53,1097,.3991994,.4688073,.0889908,.016208,.5640794,.1820848,.0665614,39.01361
18114,71828,7037,14745,38216,52961,23412,12638,6332,36024,19770,7270,12612,7132,938,5256,.7469092,.8553408,.4836894,.0636148,.612623,.3306992,.1656898,39.86117
18115,10764,883,1248,6135,7383,2818,1047,530,3577,1204,553,759,157,23,622,.7044168,.6081731,.1258013,.0184295,.4593317,.1706602,.0863896,43.72921
18116,17022,1178,1884,9759,11643,2890,1018,520,3830,1175,535,940,157,15,554,.4702886,.4989384,.0833333,.0079618,.2961369,.104314,.0532841,71.99601
18117,14832,943,1697,8902,10599,4213,1117,465,5250,1309,507,1037,192,42,467,.495228,.6110784,.1131408,.0247496,.4732644,.1254774,.0522355,42.65248
18118,33396,2603,4582,18554,23136,7520,3111,1615,10377,4425,1831,2857,1314,216,1631,.6265847,.6235269,.2867743,.047141,.4053034,.1676727,.0870432,64.16251
18119,6698,574,876,3688,4564,990,432,247,1414,492,262,424,60,15,282,.4912892,.4840183,.0684932,.0171233,.2684382,.1171367,.066974,76.78214
18120,17778,1418,1925,10267,12192,6244,2910,1598,7497,3407,1705,1253,497,107,964,.6798307,.6509091,.2581818,.0555844,.608162,.2834324,.1556443,30.31084
19001,56427,4675,7113,29922,37035,12008,4264,2201,16492,5305,2362,4484,1041,161,2799,.5987166,.6303951,.1463518,.0226346,.4013101,.1425038,.0735579,52.21772
19002,21390,1584,2343,12010,14353,5473,1704,891,6970,2110,958,1497,406,67,1027,.6483586,.6389245,.1732821,.0285958,.4557036,.1418818,.0741882,48.13786
19003,50068,4087,6437,25520,31957,14801,4635,1960,19217,5586,2152,4416,951,192,2632,.6439931,.6860338,.1477396,.0298276,.5799765,.1816223,.0768025,43.40337
19004,22084,1978,3033,10965,13998,4185,1319,715,5986,1687,758,1801,368,43,1105,.5586451,.5938015,.121332,.0141774,.381669,.1202918,.0652075,62.47251
19005,41393,3267,4532,23135,27667,8993,3184,1504,11807,3737,1548,2814,553,44,1884,.5766758,.6209179,.1220212,.0097087,.3887184,.137627,.0650097,59.67896
19006,29692,2355,3738,16162,19900,9379,3715,1842,11914,4324,2044,2535,609,202,1349,.5728238,.6781701,.1629214,.0540396,.5803118,.2298602,.113971,48.84912
19007,16387,1283,1756,9698,11454,4392,1734,845,5616,2018,875,1224,284,30,902,.7030398,.6970387,.1617312,.0170843,.4528769,.1787997,.0871314,58.70724
19008,80721,6719,11717,42752,54469,29555,12734,5486,38738,15225,5930,9183,2491,444,4271,.6356601,.783733,.2125971,.0378937,.6913127,.2978574,.1283215,33.22423
19009,252358,18047,31972,143876,175848,88677,45170,23098,112619,54374,25315,23942,9204,2217,11775,.652463,.7488427,.2878769,.0693419,.6163433,.3139509,.160541,35.45862
19010,167223,13718,23257,91089,114346,53295,24310,12365,70469,30490,13770,17174,6180,1405,8808,.6420761,.7384443,.2657264,.0604119,.5850871,.2668819,.1357464,27.48454
19011,10761,730,1176,6282,7458,2838,953,470,3552,1209,515,714,256,45,297,.4068493,.6071429,.2176871,.0382653,.451767,.1517033,.0748169,60.77542
19012,9336,859,1404,4916,6320,2185,658,341,2972,787,365,787,129,24,431,.5017462,.5605413,.0918803,.017094,.444467,.1338487,.0693653,33.88334
19013,12287,1064,1532,6774,8306,2851,927,411,3640,1060,421,789,133,10,512,.481203,.515013,.0868146,.0065274,.4208739,.1368468,.0606732,65.6883
19014,17095,1256,1729,10195,11924,4281,1910,1002,5443,2331,1075,1162,421,73,941,.7492038,.6720648,.2434933,.0422209,.4199117,.1873467,.0982835,52.83779
19015,22981,1942,2561,12454,15015,6066,2525,1128,7647,2941,1177,1581,416,49,1012,.5211123,.617337,.1624365,.0191332,.4870724,.2027461,.0905733,51.29934
19016,25727,1904,2803,14843,17646,6879,2545,1249,8601,2994,1326,1722,449,77,1176,.6176471,.6143418,.1601855,.0274706,.4634508,.1714613,.0841474,60.47523
19017,366191,33089,63691,191725,255416,138659,79712,45489,192663,107902,51419,54004,28190,5930,23964,.7242286,.8479063,.4426057,.0931058,.7232181,.4157622,.2372617,26.35896
19018,11772,1007,1393,5794,7187,2259,997,567,3047,1246,646,788,249,79,639,.6345581,.5656856,.1787509,.0567121,.3898861,.1720746,.0978599,70.68468
19019,19015,1434,2640,10464,13104,4951,1990,840,6468,2427,912,1517,437,72,822,.5732217,.5746212,.1655303,.0272727,.473146,.1901758,.0802752,61.29419
19020,33343,2644,3904,17948,21852,6692,2397,1189,8873,2863,1283,2181,466,94,1596,.6036308,.5586578,.1193648,.0240779,.3728549,.1335525,.0662469,62.51966
19021,24141,1852,2612,13552,16164,5602,2098,1116,7092,2436,1204,1490,338,88,1035,.5588553,.5704441,.1294028,.0336907,.4133707,.1548111,.0823495,63.58334
19022,16703,1138,1746,9749,11495,4599,1560,724,5730,1763,743,1131,203,19,650,.5711775,.6477664,.1162658,.010882,.4717407,.1600164,.074264,57.87027
19023,63752,5410,8890,32841,41731,16291,6319,3189,22197,8053,3502,5906,1734,313,3195,.590573,.664342,.1950506,.0352081,.4960568,.1924119,.0971042,37.27486
19024,32159,3024,4798,16762,21560,7986,2767,1293,10788,3617,1425,2802,850,132,1932,.6388889,.5839933,.1771571,.0275115,.4764348,.1650758,.0771388,54.03659
19025,17321,1118,1940,10222,12162,5080,2017,901,6559,2369,952,1479,352,51,611,.5465117,.7623711,.1814433,.0262887,.4969673,.1973195,.0881432,45.46548
19026,454592,33885,61103,253666,314769,173617,82485,41093,219122,99763,45546,45505,17278,4453,21471,.6336432,.7447261,.2827684,.0728769,.6844315,.3251717,.1619965,19.55345
19027,32168,2759,4151,17152,21303,8105,3096,1499,10872,3703,1641,2767,607,142,1610,.5835448,.6665863,.1462298,.0342086,.4725396,.1805037,.0873951,44.09199
19028,150017,13304,26218,77495,103713,49788,28537,15921,71267,39036,18045,21479,10499,2124,9023,.6782171,.8192463,.4004501,.081013,.6424673,.3682431,.2054455,36.03899
19029,82483,7770,13125,41623,54748,19175,7555,4034,28596,10769,4475,9421,3214,441,4729,.6086229,.7177905,.2448762,.0336,.4606828,.1815102,.0969176,35.69025
19030,17004,1102,1941,9968,11909,5192,1873,993,6460,2246,1164,1268,373,171,562,.5099819,.6532715,.192169,.0880989,.5208668,.1879013,.0996188,45.485
19031,39763,5772,12117,18366,30483,11877,7168,4355,22922,14332,5039,11045,7164,684,5113,.8858281,.9115292,.5912355,.0564496,.6466841,.3902864,.2371229,46.10331
19032,58806,4483,7301,30849,38150,17432,5703,2491,22350,6837,2745,4918,1134,254,2323,.5181798,.6736063,.1553212,.0347898,.565075,.1848682,.0807482,41.83963
19033,15975,1228,1777,8246,10023,3653,1607,749,4761,1919,805,1108,312,56,783,.6376222,.6235228,.1755768,.0315138,.4430027,.1948824,.0908319,65.42001
19034,34803,2767,3840,19241,23081,8972,3091,1456,11286,3641,1559,2314,550,103,1655,.5981207,.6026042,.1432292,.0268229,.4662959,.1606465,.0756717,52.73486
19035,39863,3759,6381,21101,27482,11400,5633,3384,16556,8252,3817,5156,2619,433,2869,.7632349,.8080238,.4104372,.0678577,.5402588,.2669542,.1603715,61.39647
19036,557515,41680,78449,318566,397015,188465,101695,56413,245670,131379,63274,57205,29684,6861,30344,.7280231,.7291999,.378386,.0874581,.5916042,.3192274,.1770842,31.24861
19037,139241,11781,20461,74171,94632,45341,22305,11336,60822,29685,12642,15481,7380,1306,7751,.6579238,.7566102,.3606862,.0638287,.6113036,.300724,.152836,38.43578
19038,26049,2233,3669,13220,16889,6662,2083,754,8685,2683,846,2023,600,92,1328,.5947157,.5513764,.1635323,.025075,.5039334,.1575643,.0570348,33.33765
19039,24045,2160,2981,13001,15982,5672,2032,1037,7677,2471,1107,2005,439,70,1347,.6236111,.6725931,.147266,.0234821,.4362741,.1562957,.0797631,62.44209
19040,135282,10643,17720,74683,92403,42182,18150,8914,54769,21800,9479,12587,3650,565,6254,.5876163,.7103273,.2059819,.0318849,.564814,.2430272,.1193578,42.76767
19041,10433,748,1099,5872,6971,2448,805,398,3223,967,421,775,162,23,420,.5614973,.7051865,.1474067,.0209281,.4168937,.1370913,.0677793,63.94254
19042,22187,1659,2373,12448,14821,5267,1846,949,6599,2259,1033,1332,413,84,1088,.6558167,.5613148,.1740413,.0353982,.4231202,.1482969,.0762371,60.96305
19043,25280,1893,2563,14905,17468,7294,2134,1056,8939,2479,1161,1645,345,105,1029,.5435816,.641826,.1346079,.0409676,.489366,.1431734,.0708487,55.58424
19044,64097,4911,8361,35894,44255,20678,5594,2029,26840,7150,2232,6162,1556,203,2921,.5947872,.7369932,.1861021,.0242794,.5760852,.1558478,.0565276,16.76732
19045,37259,3108,5124,19126,24250,11262,4200,1967,14972,5363,2128,3710,1163,161,1885,.6064994,.7240437,.2269711,.0314208,.588832,.2195964,.1028443,33.36833
19046,9827,912,1177,5087,6264,2282,985,440,3064,1188,465,782,203,25,639,.7006579,.664401,.1724724,.0212404,.4485945,.1936308,.086495,64.39753
19047,21495,2132,3214,10669,13883,5448,1769,875,7718,2441,994,2270,672,119,1433,.6721388,.706285,.2090853,.0370255,.5106383,.1658075,.0820133,52.03965
19048,31924,2880,4517,15973,20490,9215,3452,1565,12269,4455,1761,3054,1003,196,1833,.6364583,.6761125,.22205,.0433916,.576911,.2161147,.0979778,48.11213
19049,84128,7073,10332,44327,54659,18217,7090,3677,24778,8955,3989,6561,1865,312,4860,.68712,.6350174,.1805072,.0301974,.4109685,.1599477,.0829517,61.77502
19050,40214,3550,5640,20076,25716,7894,2595,1353,11624,3451,1485,3730,856,132,1949,.5490141,.6613475,.1517731,.0234043,.3932058,.1292588,.0673939,60.87627
19051,64253,5678,9086,32461,41547,16244,6077,2976,21744,7524,3270,5500,1447,294,3119,.5493131,.6053269,.159256,.0323575,.5004159,.1872093,.0916792,37.99136
19052,110869,8389,11755,61713,73468,41872,22040,12334,49428,24568,12766,7556,2528,432,5578,.6649184,.6427903,.2150574,.0367503,.6784956,.3571371,.1998606,42.94674
19053,80698,7299,12905,41689,54594,21236,9294,4973,30321,13172,5500,9085,3878,527,4807,.6585833,.7039907,.3005037,.0408369,.509391,.2229365,.1192881,53.64775
19054,8525,687,865,4699,5564,1986,810,428,2602,947,446,616,137,18,446,.6491994,.7121387,.1583815,.0208092,.4226431,.1723771,.0910832,66.7013
19055,94393,8200,13569,46849,60418,24664,9405,4570,33446,11627,5139,8782,2222,569,4507,.5496342,.6472105,.1637556,.0419338,.5264574,.2007513,.0975474,34.39795
19056,21167,1535,2214,12603,14817,5767,1982,1007,7345,2356,1093,1578,374,86,958,.6241043,.7127371,.168925,.0388437,.4575895,.1572641,.0799016,52.40753
19057,48458,3896,6119,26373,32492,11496,4297,2121,15640,5287,2294,4144,990,173,2263,.5808522,.6772348,.1617911,.0282726,.4359004,.1629318,.0804232,43.87552
19058,53475,5463,13525,23740,37265,15013,4995,2001,24720,6637,2347,9707,1642,346,1540,.2818964,.7177079,.1214048,.0255823,.6323926,.2104044,.0842881,54.79943
19059,44207,3505,5287,25135,30422,12391,4463,2161,15931,5365,2348,3540,902,187,2382,.6796006,.6695669,.1706071,.0353698,.4929779,.1775612,.0859757,43.39704
19060,43631,3172,4925,26059,30984,13260,5032,2317,16627,6032,2573,3367,1000,256,2073,.6535309,.6836548,.2030457,.0519797,.5088453,.1931003,.0889136,39.37113
19061,19086,1600,2647,9682,12329,4879,1667,647,6592,2200,695,1713,533,48,994,.62125,.6471477,.20136,.0181337,.5039248,.1721752,.066825,45.68307
19062,12922,937,1214,7575,8789,3207,1051,651,3880,1179,693,673,128,42,579,.6179296,.5543658,.1054366,.0345964,.4233663,.1387459,.0859406,58.50451
19063,12186,770,2210,7426,9636,3398,1621,669,4924,1935,705,1526,314,36,470,.6103896,.6904978,.1420815,.0162896,.4575815,.2182871,.0900889,65.08993
19064,17253,1179,1743,10102,11845,4896,1655,814,6033,1883,864,1137,228,50,633,.5368957,.6523236,.1308089,.0286862,.4846565,.1638289,.0805781,55.82257
20001,99657,7836,12684,57695,70379,33763,13040,6055,43239,16051,6489,9476,3011,434,5504,.7023992,.7470829,.2373857,.0342163,.585198,.2260161,.1049484,19.25372
20002,91331,7612,12336,50177,62513,30957,12556,5527,40701,15171,5891,9744,2615,364,5222,.686022,.7898833,.2119812,.0295071,.616956,.2502342,.1101501,36.98868
20003,215789,16361,28059,129988,158047,97471,47659,24656,119539,56829,26534,22068,9170,1878,12055,.7368131,.7864856,.3268114,.0669304,.7498462,.3666415,.189679,17.0252
20004,27098,2241,3694,15386,19080,10810,4185,2157,13895,5462,2273,3085,1277,116,1800,.8032129,.8351381,.3456957,.0314023,.7025868,.2720005,.1401924,25.34106
20005,41781,2870,4631,26037,30668,19170,8758,4372,22720,10113,4574,3550,1355,202,2090,.728223,.7665731,.2925934,.0436191,.7362599,.3363675,.1679149,28.59038
20006,109889,8703,13720,64599,78319,44044,19141,9697,54834,23030,10368,10790,3889,671,6590,.7572101,.7864432,.2834548,.0489067,.6818062,.2963049,.1501107,20.84116
20007,32941,1988,3164,21013,24177,15017,6642,3231,17255,7198,3342,2238,556,111,1440,.7243461,.7073325,.1757269,.0350822,.7146528,.31609,.153762,27.83948
20008,25691,1529,2294,16272,18566,12241,5998,3305,13926,6455,3414,1685,457,109,1075,.7030739,.7345248,.1992153,.0475153,.7522739,.3686087,.2031096,31.4757
20009,48968,3517,4920,29740,34660,20185,6933,3211,23690,7686,3386,3505,753,175,2496,.7096958,.7123984,.1530488,.0355691,.6787155,.2331204,.1079691,21.22372
20010,137015,12469,23037,75859,98896,54537,22576,10743,73859,31468,11794,19322,8892,1051,9840,.7891571,.8387377,.3859878,.0456223,.7189259,.2976048,.141618,20.55968
20011,17634,1139,1849,10625,12474,6945,2328,879,8323,2678,976,1378,350,97,796,.6988586,.7452677,.1892915,.0524608,.6536471,.2191059,.0827294,24.59168
20012,28795,2002,3334,16760,20094,11633,4938,2523,14147,5670,2699,2514,732,176,1405,.7017982,.7540492,.2195561,.0527894,.6940931,.2946301,.150537,21.45763
20013,45028,3278,4544,26453,30997,16873,5723,2404,20110,6380,2562,3237,657,158,2283,.6964613,.712368,.1445863,.0347711,.6378483,.216346,.0908782,25.4138
20014,28414,1975,3052,16650,19702,11195,4549,2320,13381,5067,2403,2186,518,83,1438,.7281013,.7162516,.1697248,.0271953,.6723724,.2732132,.1393393,30.47953
20015,34963,2545,3873,20932,24805,12856,4648,2157,15685,5414,2299,2829,766,142,1659,.6518664,.7304415,.1977795,.0366641,.6141793,.2220524,.103048,39.96938
20016,139666,9553,15467,83654,99121,56777,24836,12047,68372,28728,12778,11595,3892,731,6733,.7048048,.7496606,.2516325,.0472619,.6787123,.2968896,.1440098,20.49761
21001,80548,6483,10202,50241,60443,29806,9436,4654,38727,13237,5119,8921,3801,465,5096,.7860559,.8744364,.372574,.0455793,.5932605,.1878147,.0926335,22.66718
21002,370775,29190,51653,213475,265128,150490,72525,40577,190943,86842,43076,40453,14317,2499,18781,.6434053,.7831684,.2771765,.0483805,.7049537,.3397353,.1900785,14.65571
21003,655615,47755,84971,411225,496196,280829,137901,77504,351070,167856,84956,70241,29955,7452,35196,.7370118,.8266467,.352532,.0877005,.6829084,.335342,.188471,7.291669
21004,786775,61719,108554,465756,574310,225234,100856,52551,294326,128998,58766,69092,28142,6215,41219,.6678494,.6364759,.2592442,.0572526,.483588,.2165426,.1128295,23.16618
21005,34638,2657,3506,19596,23102,12667,4785,2313,15349,5257,2455,2682,472,142,1735,.6529921,.7649744,.1346264,.040502,.6464074,.2441825,.1180343,37.26454
21006,23143,1629,2502,14008,16510,6581,2576,1281,8263,2935,1355,1682,359,74,1022,.6273788,.6722622,.1434852,.0295763,.469803,.1838949,.0914477,34.29545
21007,96356,7058,10936,56937,67873,35189,15005,8126,44012,17495,8511,8823,2490,385,4920,.6970813,.8067849,.2276884,.0352048,.6180339,.2635369,.1427191,19.46088
21008,60430,4926,6707,34471,41178,20144,7954,3809,24502,9026,3995,4358,1072,186,3016,.6122615,.6497689,.159833,.0277322,.5843753,.2307447,.1104987,22.19693
21009,72751,6277,8488,38300,46788,26412,10548,4749,32620,12124,5076,6208,1576,327,4010,.6388402,.7313855,.1856739,.038525,.6896083,.2754047,.1239948,29.18681
21010,30623,2017,3298,19403,22701,8715,3089,1589,11087,3543,1696,2372,454,107,1207,.5984135,.7192238,.1376592,.0324439,.4491574,.1592022,.0818946,39.41084
21011,114792,8487,14195,66339,80534,42092,19651,11212,53994,23853,11990,11902,4202,778,5909,.6962413,.8384643,.2960197,.054808,.6344985,.2962209,.1690107,23.46675
21012,26498,2035,3151,15153,18304,8167,2443,1191,10598,3031,1287,2431,588,96,1221,.6,.7715011,.1866074,.0304665,.5389692,.1612222,.0785983,43.42019
21013,145930,12421,17834,82290,100124,56888,26882,14052,70087,30917,15005,13199,4035,953,8117,.6534901,.7401032,.2262532,.0534373,.6913112,.326674,.1707619,18.03424
21014,118572,8340,12114,70178,82292,58304,39936,27044,68169,44586,28543,9865,4650,1499,6483,.7773381,.814347,.3838534,.1237411,.8308017,.5690672,.3853629,16.24535
21015,16695,1417,2380,10260,12640,5526,2510,1296,7325,3239,1348,1799,729,52,1011,.7134792,.7558824,.3063025,.0218487,.5385965,.2446394,.1263158,32.6879
21016,579053,40212,63526,361446,424972,315627,224587,154719,369237,254106,163581,53610,29519,8862,33092,.8229384,.8439064,.4646759,.1395019,.8732342,.621357,.4280556,6.288978
21017,665071,55122,102956,367900,470856,284865,144723,77479,369441,183313,85643,84576,38590,8164,40297,.7310511,.8214771,.3748203,.079296,.7743001,.3933759,.210598,8.821815
21018,25508,1746,2710,15745,18455,8763,3773,1953,10701,4314,2092,1938,541,139,1126,.6449026,.7151291,.199631,.0512915,.5565577,.2396316,.1240394,36.73274
21019,59895,5166,8833,31144,39977,20933,8370,4350,27859,10246,4686,6926,1876,336,3382,.6546651,.7841051,.2123854,.0380392,.6721359,.2687516,.1396738,33.40442
21020,19188,1744,2632,11576,14208,5176,1996,949,7080,2647,1020,1904,651,71,1310,.7511468,.7234042,.2473404,.0269757,.447132,.1724257,.08198,44.22399
21021,25604,1796,2775,16918,19693,10097,5379,3058,11938,5888,3231,1841,509,173,1189,.6620267,.6634234,.1834234,.0623423,.5968199,.3179454,.1807542,31.94555
21022,113086,8264,14328,68705,83033,41063,13778,6512,51172,16170,7001,10109,2392,489,5119,.6194337,.7055416,.1669458,.034129,.5976712,.2005385,.094782,22.71722
21023,64540,4961,8834,38668,47502,21758,10020,5509,28723,12797,5971,6965,2777,462,3461,.6976416,.788431,.3143536,.0522979,.5626875,.259129,.1424692,27.26048
21024,30889,2156,3688,19362,23050,10227,4629,2219,13026,5457,2419,2799,828,200,1351,.6266234,.758948,.2245119,.0542299,.5281996,.2390765,.1146059,40.16103
22001,147925,8812,13791,99368,113159,85284,46716,23589,96861,51130,24472,11577,4414,883,6460,.7330912,.8394605,.3200638,.0640273,.8582642,.4701312,.2373903,17.70949
22002,145110,11869,18746,89155,107901,62126,27013,14505,78008,34301,15553,15882,7288,1048,9242,.7786671,.8472207,.3887763,.0559053,.6968313,.3029892,.1626942,13.85064
22003,474641,34647,55889,285607,341496,150111,62337,30754,188698,76849,33202,38587,14512,2448,23226,.670361,.6904221,.2596575,.0438011,.5255858,.2182615,.1076794,16.65288
22004,8942,441,760,6179,6939,5260,2744,1463,5919,3014,1560,659,270,97,254,.5759637,.8671052,.3552631,.1276316,.8512704,.4440848,.2367697,24.34918
22005,633632,46347,74624,390253,464877,284738,137692,71294,344656,163453,77075,59918,25761,5781,34351,.7411699,.802932,.3452106,.0774684,.7296241,.3528275,.1826866,12.0432
22006,64317,4165,7669,39997,47666,29419,14458,7645,35602,17207,8230,6183,2749,585,2965,.7118847,.8062329,.3584561,.0762811,.7355301,.3614771,.1911393,15.12888
22007,443018,34463,56664,266064,322728,177049,74663,37500,221693,93829,41177,44644,19166,3677,25000,.7254156,.7878724,.3382395,.0648913,.6654376,.2806205,.1409435,11.97813
22008,138813,15717,34668,74541,109209,55170,31333,18535,87660,53024,20616,32490,21691,2081,13961,.8882738,.9371755,.6256779,.0600265,.7401296,.4203458,.2486551,11.65804
22009,1367034,106730,190345,829184,1019529,642084,350506,218409,805569,434891,242066,163485,84385,23657,83818,.7853274,.8588878,.4433266,.1242848,.7743565,.422712,.2634023,9.049252
22010,5087,263,445,3502,3947,2867,1249,654,3274,1439,715,407,190,61,221,.8403042,.9146068,.4269663,.1370787,.818675,.3566533,.1867504,15.69966
22011,606587,47188,76480,374890,451370,307292,164154,96257,372782,198600,105990,65490,34446,9733,38806,.8223701,.8563023,.4503922,.127262,.8196858,.4378724,.2567607,7.276654
22012,405437,29745,43767,233740,277507,180325,83568,41245,214951,96890,43925,34626,13322,2680,22621,.7604976,.791144,.3043846,.0612333,.7714769,.3575255,.1764567,12.34532
22013,650142,53239,121843,386624,508467,262017,122717,72570,363857,182749,90168,101840,60032,17598,41735,.7839178,.8358297,.4926996,.1444318,.6777049,.3174066,.1877017,17.27095
22014,646352,50302,86000,384152,470152,256225,119949,59210,326004,150496,64779,69779,30547,5569,36834,.7322572,.8113837,.3551977,.0647558,.6669886,.3122436,.1541317,12.49904
23001,9740,674,800,6398,7198,3786,1084,446,4333,1186,455,547,102,9,449,.6661721,.68375,.1275,.01125,.5917474,.1694279,.0697093,29.34418
23002,9225,639,890,5548,6438,3506,1111,527,4221,1232,558,715,121,31,454,.7104852,.8033708,.1359551,.0348315,.6319394,.2002523,.0949892,28.37469
23003,81555,6219,9694,45789,55483,29666,11119,4649,36743,12604,4868,7077,1485,219,4165,.6697218,.7300392,.1531875,.0225913,.6478848,.2428312,.1015309,17.02766
23004,32315,2962,4048,18272,22320,11673,4415,1608,14882,5247,1686,3209,832,78,2153,.7268738,.7927371,.2055336,.0192688,.6388463,.2416265,.0880035,17.56269
23005,16194,1136,1633,9824,11457,6708,2496,1168,7943,2783,1208,1235,287,40,778,.6848592,.7562768,.1757502,.0244948,.6828176,.2540717,.1188925,33.398
23006,14706,1121,1608,8625,10233,4605,1294,536,5769,1478,574,1164,184,38,783,.6984835,.7238806,.1144279,.0236318,.533913,.150029,.0621449,29.52635
23007,8484,584,817,5035,5852,3318,1141,414,3967,1306,438,649,165,24,402,.6883562,.7943696,.2019584,.0293758,.6589871,.2266137,.0822244,31.55773
23008,45781,3555,4887,26506,31393,18396,6335,2767,22034,7081,2873,3638,746,106,2581,.7260197,.744424,.1526499,.0216902,.6940315,.2390025,.1043915,17.2578
23009,119881,9597,15604,67524,83128,43496,15856,6021,55797,19128,6499,12301,3272,478,6774,.7058456,.7883235,.2096898,.0306332,.6441562,.2348202,.0891683,14.27936
23010,11205,844,1183,6779,7962,4566,1971,833,5422,2201,897,856,230,64,545,.6457346,.7235841,.194421,.0540997,.6735507,.2907509,.1228795,26.52648
23011,171276,13017,20321,98331,118652,63735,28032,13084,78226,33510,14110,14491,5478,1026,9161,.703772,.7131047,.2695734,.0504896,.6481679,.285078,.1330608,15.17729
23012,40188,3042,4895,23255,28150,15197,4699,2030,18481,5335,2137,3284,636,107,1930,.634451,.6708887,.1299285,.021859,.6534939,.2020641,.0872931,19.35688
23013,141557,10736,17209,83277,100486,56424,22691,9882,69648,27097,10433,13224,4406,551,7787,.7253167,.7684351,.2560288,.0320181,.677546,.2724762,.1186642,14.07372
23014,49499,3568,5266,29011,34277,18390,6226,2344,21926,7078,2463,3536,852,119,2513,.7043161,.6714774,.1617926,.0225978,.6338975,.2146083,.0807969,20.33746
23015,19907,1508,2295,11636,13931,8066,3264,1525,9805,3708,1596,1739,444,71,1033,.6850132,.7577342,.1934641,.0309368,.6931936,.2805088,.1310588,25.2164
23016,20649,1522,2069,12257,14326,7895,2852,1118,9406,3164,1190,1511,312,72,1011,.6642575,.7303045,.1507975,.0347994,.6441217,.2326834,.0912132,32.56054
23017,29029,2545,4507,16509,21016,10677,3978,1826,14461,5389,1982,3784,1411,156,1809,.7108055,.8395829,.3130686,.0346128,.6467382,.2409595,.1106063,22.79714
23018,23822,1612,2379,14538,16917,8408,2623,939,10126,3031,1004,1718,408,65,1238,.7679901,.7221522,.1715006,.0273224,.5783464,.1804237,.0645894,31.4276
23019,55893,4704,6362,30256,36618,22085,8026,3423,27114,9261,3623,5029,1235,200,3409,.7247024,.7904747,.1941213,.0314367,.7299379,.2652697,.1131346,16.94095
23020,9465,746,1053,5533,6586,3923,1358,531,4611,1540,537,688,182,6,427,.5723861,.6533713,.1728395,.005698,.7090186,.2454365,.0959696,30.40834
23021,38947,2986,4041,22586,26627,15523,5871,2363,18811,6717,2446,3288,846,83,2257,.7558607,.81366,.2093541,.0205395,.6872842,.2599398,.1046223,23.30166
23022,25341,1580,2586,15870,18456,11014,3797,1658,13184,4340,1773,2170,543,115,1032,.6531646,.8391338,.2099768,.0444702,.6940138,.2392565,.1044739,23.3889
23023,88337,6814,11131,49269,60400,38473,16595,7790,47658,20107,8529,9185,3512,739,5073,.7444966,.825173,.3155152,.0663912,.7808764,.3368244,.1581116,13.9067
23024,22992,1763,2778,13491,16269,10178,4828,2368,12385,5559,2526,2207,731,158,1324,.7509927,.7944564,.2631389,.0568754,.7544289,.3578682,.1755244,27.32896
23025,450449,36255,60871,244826,305697,165883,67090,26758,211061,80695,29001,45178,13605,2243,25795,.7114881,.7421925,.2235055,.0368484,.6775547,.2740313,.1092939,13.73372
23026,19957,1429,2047,12028,14075,6907,2057,730,8377,2381,792,1470,324,62,1009,.7060882,.7181241,.1582804,.0302882,.5742434,.1710176,.0606917,24.02177
23027,19686,1374,1940,12941,14881,8491,3263,1242,10110,3858,1326,1619,595,84,1028,.7481805,.8345361,.306701,.043299,.6561317,.2521443,.095974,25.85726
23028,54899,4145,7199,31536,38735,24332,12620,6023,30136,14719,6494,5804,2099,471,2976,.7179735,.8062231,.2915683,.0654258,.7715626,.4001776,.1909881,20.06874
23029,40448,3411,5484,22362,27846,15521,5123,2480,19850,6673,2616,4329,1550,136,2542,.745236,.7893873,.2826404,.0247994,.6940792,.229094,.1109024,19.88134
23030,42071,3463,5465,23851,29316,16384,5128,2344,20502,6295,2495,4118,1167,151,2533,.7314467,.7535224,.2135407,.0276304,.6869314,.2150015,.0982768,21.59127
23031,37872,4545,8972,20142,29114,12735,5738,2899,21165,10718,3431,8430,4980,532,3909,.860066,.9395899,.5550602,.0592956,.6322609,.2848774,.1439281,29.23545
23032,36459,2688,3950,21512,25462,12332,3978,1720,15376,4659,1896,3044,681,176,1781,.6625744,.7706329,.1724051,.044557,.5732614,.18492,.0799554,30.85523
23033,275520,27670,63548,139834,203382,109052,62947,36288,165476,97917,41990,56424,34970,5702,23087,.8343694,.8878958,.5502927,.0897274,.7798675,.4501552,.2595077,12.9151
23034,51815,4507,8125,27177,35302,18263,5873,2179,23135,6954,2346,4872,1081,167,2706,.6003994,.5996308,.1330462,.0205538,.6720021,.2161019,.0801781,19.88266
23035,28349,2178,4150,16052,20202,10906,4088,1798,14240,4706,1890,3334,618,92,1354,.6216713,.8033735,.1489157,.0221687,.6794169,.2546723,.112011,25.55639
23036,13635,872,1099,9302,10401,5902,1954,937,6722,2160,1005,820,206,68,621,.7121559,.7461329,.1874431,.0618744,.6344872,.2100624,.100731,21.53435
23037,54110,7574,17206,23425,40631,16595,8082,4828,32643,18489,5881,16048,10407,1053,6704,.8851333,.9326979,.6048471,.0611996,.7084312,.345016,.2061046,22.30111
23038,151495,11231,18887,88518,107405,61248,25742,10816,75430,30402,11644,14182,4660,828,7863,.7001157,.7508869,.2467306,.0438397,.6919271,.2908109,.1221898,12.72252
23039,212378,18743,39084,116578,155662,88324,48228,26857,121789,67106,29890,33465,18878,3033,14489,.7730353,.8562327,.4830109,.0776021,.7576386,.4136973,.2303779,11.87451
23040,10952,715,1124,6215,7339,3896,1363,488,4675,1510,509,779,147,21,469,.655944,.6930605,.1307829,.0186833,.6268705,.2193081,.0785197,37.05002
23041,444506,35551,64852,248187,313039,175868,84654,40342,227941,105475,44134,52073,20821,3792,25627,.7208517,.8029513,.3210541,.0584716,.7086108,.3410896,.1625468,13.06391
23042,1963,94,143,1410,1553,702,237,100,826,255,100,124,18,0,77,.819149,.8671328,.1258741,0,.4978724,.1680851,.070922,30.77233
23043,7711,494,552,5063,5615,2485,853,348,2814,921,353,329,68,5,353,.7145749,.5960145,.1231884,.009058,.4908157,.1684772,.068734,43.54222
23044,70038,5631,7877,37063,44940,25013,8270,3176,30631,9283,3327,5618,1013,151,3926,.6972119,.7132157,.1286023,.0191697,.6748779,.2231336,.0856919,19.65441
23045,14007,1005,1330,8657,9987,6652,3412,1677,7759,3737,1723,1107,325,46,786,.7820895,.8323308,.2443609,.0345865,.7683955,.3941319,.1937161,32.59991
23046,89948,7070,11025,50849,61874,34487,12654,6040,42792,15173,6480,8305,2519,440,5047,.7138614,.753288,.2284807,.0399093,.6782238,.2488545,.1187831,16.88506
23047,100289,7915,10442,55328,65770,42757,18790,9035,50599,20832,9386,7842,2042,351,5867,.7412508,.7510055,.1955564,.0336143,.7727913,.3396111,.1632989,17.35256
23048,6659,448,667,4053,4720,2369,971,453,2776,1054,468,407,83,15,257,.5736607,.6101949,.1244378,.0224888,.5845053,.2395756,.1117691,29.28843
23049,10178,818,983,6134,7117,3865,1243,569,4627,1392,590,762,149,21,603,.7371638,.775178,.1515768,.0213632,.6300945,.202641,.0927617,29.26782
23050,694600,55728,90924,396580,487504,274237,106356,42723,346352,129795,46526,72115,23439,3803,40459,.7260085,.7931349,.2577867,.0418261,.6915049,.268183,.1077286,9.502703
23051,23019,1742,2502,14116,16618,8787,3037,1363,10684,3521,1432,1897,484,69,1301,.7468427,.7581934,.1934453,.0275779,.6224851,.2151459,.0965571,19.24343
23052,74101,6607,14514,38878,53392,29403,13069,6805,42229,18375,7446,12826,5306,641,4728,.7156047,.8836985,.3655781,.0441643,.7562889,.3361541,.1750347,20.11942
23053,26365,1886,2907,16078,18985,10627,3866,1605,12895,4504,1715,2268,638,110,1409,.7470838,.7801858,.2194702,.0378397,.6609653,.2404528,.0998259,19.03897
23054,36961,5501,11817,16537,28354,11508,5202,2469,22580,11585,2936,11072,6383,467,4883,.8876568,.9369552,.540154,.0395193,.6958941,.3145673,.1493016,28.92709
23055,26201,2034,3001,15378,18379,10313,3069,1251,12658,3537,1298,2345,468,47,1340,.6588004,.7814062,.155948,.0156614,.6706334,.1995708,.08135,28.95663
23056,73578,6050,9267,40532,49799,31162,15859,9208,38575,18785,9769,7413,2926,561,4755,.7859504,.7999353,.315744,.0605374,.7688246,.3912711,.2271785,12.71057
23057,10009,755,1104,5690,6794,3387,1084,403,4167,1215,421,780,131,18,489,.6476821,.7065217,.1186594,.0163043,.5952548,.1905097,.070826,34.28239
23058,134659,10887,16372,73432,89804,46520,15697,6505,58510,18669,6930,11990,2972,425,7381,.6779646,.7323479,.1815294,.025959,.6335113,.2137624,.0885854,16.00823
23059,47555,3535,5379,27100,32479,17291,6002,2378,20914,7002,2534,3623,1000,156,2517,.7120226,.6735452,.1859082,.0290017,.6380443,.221476,.0877491,23.36459
23060,7492,470,722,4710,5432,2832,910,303,3368,988,314,536,78,11,306,.6510639,.7423823,.1080332,.0152355,.6012739,.1932059,.0643312,33.30427
23061,157589,12920,19960,89173,109133,58207,23249,9469,72854,28098,10123,14647,4849,654,9741,.7539474,.7338176,.2429359,.0327655,.6527424,.2607179,.1061869,15.21178
23062,34917,2683,3569,20336,23905,12320,4154,1808,14826,4747,1886,2506,593,78,1944,.724562,.7021574,.166153,.0218549,.6058222,.2042683,.0889064,26.09484
23063,1011793,72790,121269,600699,721968,467578,256719,144500,563640,295030,153949,96062,38311,9449,53971,.7414618,.7921398,.3159175,.0779177,.7783899,.4273671,.2405531,9.854413
23064,22002,1749,2324,12542,14866,7982,2843,1158,9625,3278,1216,1643,435,58,1266,.7238422,.7069708,.1871773,.024957,.6364216,.2266784,.0923298,24.51511
23065,16436,1232,1657,9987,11644,5741,1772,678,6872,2004,739,1131,232,61,780,.6331169,.6825588,.1400121,.0368135,.5748473,.1774307,.0678883,36.16424
23066,9861,704,754,6120,6874,3956,1322,546,4498,1463,574,542,141,28,594,.84375,.7188329,.1870027,.0371353,.6464052,.2160131,.0892157,25.42099
23067,18928,1418,1957,10922,12879,6743,2126,912,8200,2407,964,1457,281,52,987,.6960508,.7445069,.1435871,.0265713,.6173778,.194653,.0835012,29.89857
23068,6858,475,637,4303,4940,2552,833,332,3025,915,344,473,82,12,299,.6294737,.7425432,.1287284,.0188383,.5930746,.1935859,.0771555,30.34046
23069,14993,1072,1531,8481,10012,6013,2448,1193,7246,2705,1222,1233,257,29,811,.7565299,.805356,.1678641,.0189419,.7089966,.2886452,.1406674,27.03018
23070,157174,13690,22128,84991,107119,58763,26275,12480,76579,33006,13335,17816,6731,855,10110,.7384952,.8051338,.3041847,.0386388,.6914026,.3091504,.1468391,12.24465
23071,14267,1063,1447,8590,10037,4892,1649,651,6032,1882,693,1140,233,42,721,.678269,.7878369,.1610228,.0290256,.5694994,.1919674,.0757858,25.14001
23072,16374,1150,1515,10893,12408,6847,2307,877,7869,2646,891,1022,339,14,759,.66,.6745875,.2237624,.0092409,.6285688,.2117874,.0805104,26.78371
23073,228059,18282,29116,124520,153636,81889,30654,14018,103556,36954,15039,21667,6300,1021,12930,.707253,.7441613,.2163759,.0350666,.6576373,.2461773,.1125763,16.07014
23074,138802,10919,16444,78018,94462,50742,18259,7218,62795,21743,7616,12053,3484,398,7898,.7233263,.7329725,.2118706,.0242034,.6503884,.2340357,.0925171,20.03539
23075,56083,4009,6492,32411,38903,21295,7220,3008,25756,8292,3194,4461,1072,186,2804,.6994263,.6871534,.1651263,.0286506,.65703,.2227639,.092808,17.22728
23076,40789,3114,4450,23578,28028,14340,4220,1784,17616,4867,1906,3276,647,122,2196,.7052023,.7361798,.1453933,.0274157,.6081941,.1789804,.0756638,24.20739
23077,8575,607,847,5195,6042,3052,1012,473,3640,1071,486,588,59,13,403,.6639209,.6942149,.0696576,.0153483,.587488,.1948027,.0910491,30.46475
23078,71140,5570,8440,38777,47217,26222,8873,3572,32314,10028,3787,6092,1155,215,3842,.6897666,.7218009,.1368483,.0254739,.6762256,.2288212,.0921165,15.28166
23079,56961,4484,6573,31316,37889,19618,6088,2471,24394,7151,2633,4776,1063,162,3091,.6893399,.7266089,.1617222,.0246463,.6264529,.1944054,.0789054,21.01193
23080,66814,4795,7249,38453,45702,23877,9193,3890,28656,10463,4144,4779,1270,254,3213,.670073,.6592634,.1751966,.0350393,.6209399,.2390711,.1011625,20.67409
23081,264748,23955,59407,141291,200698,114327,77116,50960,167774,113336,60261,53447,36220,9301,19562,.8166145,.8996751,.6096925,.156564,.8091598,.5457956,.3606741,13.15553
23082,2337891,168676,301582,1350573,1652155,829468,352649,150684,1042819,429399,164571,213351,76750,13887,116623,.6914024,.7074394,.2544913,.0460472,.6141601,.2611107,.1115704,16.49335
23083,25102,1810,2735,14678,17413,9182,3258,1515,11139,3700,1581,1957,442,66,1203,.6646409,.7155393,.1616088,.0241316,.6255621,.2219649,.1032157,23.46525
24001,13404,956,1170,8512,9682,5238,1877,718,6120,2144,771,882,267,53,696,.7280335,.7538462,.2282051,.0452991,.6153665,.2205122,.0843515,42.48752
24002,195998,16370,24965,101501,126466,81296,31952,14030,100921,37779,14977,19625,5827,947,11848,.723763,.7861006,.2334068,.0379331,.800938,.3147949,.1382252,6.789649
24003,29336,2224,3208,16848,20056,10129,4034,1748,12514,4685,1851,2385,651,103,1595,.7171763,.7434539,.2029302,.0321072,.601199,.2394349,.1037512,36.44248
24004,30982,3292,5990,15964,21954,10470,5378,2762,15606,8077,3073,5136,2699,311,2575,.7821993,.857429,.4505843,.0519199,.6558506,.336883,.1730143,39.04766
24005,25187,1938,3494,13393,16887,8888,3537,1696,11784,4581,1903,2896,1044,207,1458,.752322,.8288494,.2987979,.0592444,.6636302,.2640932,.1266333,29.83691
24006,7716,537,709,4875,5584,3022,1045,449,3594,1238,480,572,193,31,405,.75419,.8067701,.2722144,.0437236,.6198974,.214359,.0921026,46.03411
24007,52314,5488,11827,27483,39310,20618,10549,5022,31544,16770,5661,10926,6221,639,4684,.8534985,.9238184,.5259998,.0540289,.7502092,.3838373,.1827311,23.748
24008,28645,2431,3930,16521,20451,10154,3602,1641,13388,4858,1802,3234,1256,161,1934,.7955574,.8229008,.3195929,.0409669,.6146117,.2180256,.0993281,27.3979
24009,29936,2274,3112,17540,20652,11697,4237,1864,13979,4885,2002,2282,648,138,1700,.7475814,.7332905,.2082262,.0443445,.6668757,.2415621,.1062714,15.38405
24010,37046,3033,5113,20037,25150,14633,6202,3123,18762,7435,3312,4129,1233,189,2255,.7434883,.8075494,.24115,.0369646,.7302989,.3095274,.1558617,20.56565
24011,21050,1505,1668,13268,14936,8353,3219,1341,9531,3502,1381,1178,283,40,1136,.7548172,.706235,.1696643,.0239808,.6295598,.2426138,.1010702,41.97577
24012,14941,1061,1472,9216,10688,5731,2220,896,6929,2685,950,1198,465,54,873,.8228087,.8138587,.3158967,.0366848,.6218533,.2408854,.0972222,31.68947
24013,25717,1983,2705,14429,17134,9849,3540,1553,11817,3938,1610,1968,398,57,1388,.6999496,.7275416,.1471349,.0210721,.6825837,.2453392,.1076305,21.01123
24014,49327,5802,11900,24800,36700,18107,9407,4469,28947,15827,4953,10840,6420,484,4923,.8485005,.9109244,.5394958,.0406723,.730121,.3793145,.1802016,15.59596
24015,8761,679,872,5112,5984,2686,969,427,3322,1130,455,636,161,28,499,.7349043,.7293578,.184633,.0321101,.5254304,.189554,.083529,39.54941
24016,4092,265,394,2627,3021,2006,1008,488,2312,1095,494,306,87,6,190,.7169811,.7766498,.2208122,.0152284,.7636087,.3837076,.1857632,16.09267
24017,14854,965,1406,9173,10579,5855,2200,909,6891,2573,986,1036,373,77,804,.8331606,.7368421,.2652916,.0547653,.6382863,.2398343,.0990952,30.69773
24018,41722,3234,4288,25217,29505,16391,6495,2790,19515,7525,2909,3124,1030,119,2458,.7600495,.7285448,.2402052,.0277519,.649998,.2575643,.1106396,23.34313
24019,194279,15101,23777,104596,128373,87471,43228,22633,107214,50427,24201,19743,7199,1568,11305,.7486259,.8303403,.3027716,.0659461,.8362748,.4132854,.2163849,9.070511
24020,14773,1100,1556,8381,9937,5749,2175,810,6995,2495,871,1246,320,61,787,.7154545,.8007712,.2056555,.0392031,.6859564,.2595156,.0966472,27.03334
24021,27839,2358,3586,16281,19867,10231,4357,1819,13277,5579,1962,3046,1222,143,1928,.8176421,.8494144,.3407696,.0398773,.6284012,.2676125,.1117253,34.49209
24022,19714,1379,2042,12253,14295,7872,3130,1378,9492,3584,1472,1620,454,94,1146,.831037,.7933398,.222331,.0460333,.6424549,.2554477,.1124623,29.66558
24023,21930,1518,2070,13509,15579,8281,3087,1273,9781,3509,1361,1500,422,88,1169,.7700922,.7246377,.2038647,.0425121,.6129987,.2285143,.0942335,31.34111
24024,36329,2617,3949,22040,25989,14349,5241,2084,17485,6150,2231,3136,909,147,2039,.7791364,.7941251,.2301849,.0372246,.6510435,.2377949,.0945554,22.13952
24025,38749,3073,4115,23106,27221,15186,5888,2750,18294,6745,2889,3108,857,139,2383,.7754637,.7552856,.2082625,.0337789,.6572319,.2548256,.1190167,21.67734
24026,7171,484,613,4617,5230,2730,1053,407,3235,1292,447,505,239,40,419,.8657025,.8238173,.3898858,.0652529,.591293,.2280702,.0881525,38.06997
24027,941411,67191,136999,570816,707815,466393,263436,143518,581765,321752,157886,115372,58316,14368,49381,.7349347,.8421375,.4256673,.1048767,.8170636,.4615077,.251426,9.744424
24028,18382,1388,1979,10790,12769,6934,2719,1343,8473,3260,1436,1539,541,93,1104,.7953891,.7776655,.2733704,.0469934,.6426321,.2519926,.1244671,29.15017
24029,14098,1042,1283,8584,9867,5506,2412,1068,6496,2721,1090,990,309,22,804,.7715931,.771629,.2408418,.0171473,.6414259,.2809879,.1244175,38.00197
24030,23600,1858,2544,12999,15543,8456,2965,1291,10231,3368,1390,1775,403,99,1252,.6738428,.6977201,.1584119,.0389151,.6505116,.2280945,.0993153,24.59145
24031,43069,3110,4557,25015,29572,17519,7609,3092,21105,8754,3215,3586,1145,123,2283,.7340836,.7869212,.2512618,.0269914,.7003398,.3041775,.1236058,29.31727
24032,13690,1017,1694,8192,9886,5275,1983,820,6691,2431,880,1416,448,60,815,.8013766,.8358914,.2644628,.0354191,.6439209,.2420654,.1000977,34.31866
24033,12161,880,1249,7002,8251,4112,1247,604,4986,1454,664,874,207,60,575,.6534091,.6997598,.1657326,.0480384,.5872608,.178092,.0862611,30.59345
24034,36763,3105,5234,21121,26355,13859,6331,2629,18321,8087,2827,4462,1756,198,2487,.8009662,.8525029,.3354987,.0378296,.6561716,.2997491,.1244733,26.88281
24035,6672,410,613,4229,4842,2617,1250,408,3139,1437,448,522,187,40,314,.7658536,.8515497,.3050571,.0652529,.6188224,.2955782,.0964767,26.33251
24036,17571,1412,2032,10149,12181,6645,2457,1039,8201,2927,1090,1556,470,51,1113,.7882437,.765748,.2312992,.0250984,.6547443,.2420928,.1023746,15.79562
24037,10592,680,1046,6670,7716,3906,1496,615,4749,1814,671,843,318,56,536,.7882353,.8059273,.3040153,.0535373,.5856072,.2242879,.0922039,41.67701
24038,13043,1033,1390,7801,9191,5684,1923,847,6809,2156,880,1125,233,33,780,.7550823,.8093525,.1676259,.023741,.7286245,.2465069,.1085758,11.60586
24039,3764,299,342,2331,2673,1401,537,267,1653,579,281,252,42,14,177,.5919732,.7368421,.122807,.0409357,.6010296,.2303732,.1145431,34.45065
24040,23434,1751,2489,13453,15942,8944,3526,1641,10850,4105,1718,1906,579,77,1383,.7898344,.7657694,.2326235,.0309361,.6648331,.2620977,.1219802,28.46054
24041,8207,582,733,5059,5792,2874,1045,433,3422,1212,465,548,167,32,480,.8247423,.7476125,.2278308,.0436562,.5680965,.2065626,.08559,41.27998
24042,25207,2295,4122,13808,17930,8959,3660,1718,12486,5224,1880,3527,1564,162,1942,.8461874,.8556526,.3794275,.0393013,.6488268,.2650637,.1244206,31.3809
24043,29657,2084,3240,17377,20617,11002,3520,1484,13605,4188,1607,2603,668,123,1573,.7547985,.803395,.2061728,.037963,.6331357,.2025666,.0854002,24.84786
24044,5535,445,501,3080,3581,1587,578,247,1935,656,267,348,78,20,345,.7752809,.6946108,.1556886,.0399202,.5152597,.1876623,.0801948,43.45492
24045,13027,936,1192,7637,8829,4313,1874,650,5256,2233,713,943,359,63,727,.7767094,.7911074,.3011745,.0528523,.5647506,.2453843,.085112,28.22694
24046,24687,1678,2758,15151,17909,9792,3711,1471,11907,4401,1602,2115,690,131,1313,.7824792,.7668601,.2501813,.0474982,.646294,.2449343,.0970893,26.31084
24047,20594,1459,2042,12228,14270,7584,2585,1077,9209,2986,1144,1625,401,67,1111,.7614805,.7957885,.1963761,.032811,.6202159,.2114001,.0880765,36.22131
24048,18430,1468,1878,10805,12683,6228,2120,940,7598,2485,1030,1370,365,90,1074,.7316076,.7294995,.1943557,.0479233,.5763998,.1962055,.0869968,29.80635
24049,29311,2401,3064,16124,19188,8783,2921,1324,11112,3459,1407,2329,538,83,1771,.7376093,.7601175,.1755875,.0270888,.5447159,.1811585,.0821136,38.87062
24050,40390,3292,4262,24853,29115,16544,6300,2571,19814,7540,2736,3270,1240,165,2724,.8274605,.7672454,.2909432,.0387142,.6656741,.2534905,.1034483,15.14606
24051,11507,860,1093,6871,7964,4107,1372,551,4970,1634,583,863,262,32,698,.8116279,.78957,.2397072,.0292772,.5977296,.1996798,.0801921,33.59275
24052,26929,2828,5130,14154,19284,10416,5078,2699,14876,7479,2875,4460,2401,176,2470,.8734088,.8693957,.4680312,.034308,.7359051,.3587678,.1906881,20.74883
24053,21840,1731,2619,12893,15512,7842,3090,1162,9869,3840,1316,2027,750,154,1434,.8284229,.7739595,.2863688,.0588011,.608237,.2396649,.0901264,31.97935
24054,9379,621,802,5900,6702,3310,1328,473,3931,1584,501,621,256,28,490,.7890499,.7743142,.319202,.0349127,.561017,.2250848,.0801695,29.01762
24055,92006,7257,12975,51707,64682,42252,23401,12824,53419,28812,14056,11167,5411,1232,5771,.7952322,.8606551,.4170327,.0949518,.8171427,.4525693,.2480128,15.12948
24056,51937,3845,5343,32174,37517,18956,8082,3359,23117,9420,3527,4161,1338,168,3054,.7942783,.778776,.2504211,.031443,.5891714,.2511966,.1044011,32.84016
24057,15258,1306,2148,8637,10785,5735,2747,1039,7448,3419,1114,1713,672,75,935,.7159265,.797486,.3128492,.0349162,.6640037,.3180502,.1202964,24.335
24058,19871,1494,2022,11669,13691,6918,2272,1033,8369,2545,1113,1451,273,80,1060,.7095047,.7176063,.1350148,.0395648,.5928528,.1947039,.0885252,34.30962
24059,11690,931,1327,7023,8350,3996,1503,643,5047,1848,704,1051,345,61,803,.8625134,.792012,.2599849,.0459684,.5689876,.2140111,.0915563,34.63592
24060,34844,2912,4444,20126,24570,12646,5558,2358,16262,7057,2506,3616,1499,148,2329,.799794,.8136814,.3373087,.0333033,.6283414,.2761602,.1171619,22.43014
24061,11657,811,1081,7290,8371,4474,1671,680,5295,1944,718,821,273,38,674,.8310727,.759482,.2525439,.0351526,.6137174,.2292181,.0932785,35.22863
24062,459784,35888,71098,267733,338831,206636,105158,59744,267992,133786,66728,61356,28628,6984,27572,.7682791,.8629779,.4026555,.0982306,.7717988,.3927719,.2231477,10.25578
24063,5471,453,598,3044,3642,1661,554,212,2130,679,239,469,125,27,352,.777042,.784281,.2090301,.0451505,.5456636,.1819974,.0696452,26.69104
24064,19341,1427,1985,11650,13635,7028,2539,1100,8555,3063,1173,1527,524,73,1144,.8016819,.7692695,.2639799,.0367758,.6032618,.2179399,.0944206,34.37998
24065,20401,1441,2084,12302,14386,7423,2742,1029,9132,3338,1104,1709,596,75,1197,.8306732,.8200576,.2859885,.0359885,.6033978,.2228906,.0836449,32.84909
24066,46087,5057,9044,23920,32964,16320,7188,3852,24269,11400,4129,7949,4212,277,4310,.852284,.8789253,.4657231,.030628,.6822742,.3005017,.1610368,22.51968
24067,10703,709,1089,6374,7463,3795,1308,486,4689,1621,561,894,313,75,581,.819464,.8209366,.2874196,.0688705,.5953875,.2052087,.0762473,24.24695
24068,12574,860,1363,7259,8622,4036,1572,654,5094,1863,694,1058,291,40,567,.6593024,.7762289,.2134996,.029347,.5559995,.2165588,.0900951,34.20324
24069,222229,17682,31255,130715,161970,94142,41985,19307,120273,52968,20834,26131,10983,1527,13649,.771915,.8360583,.3513998,.0488562,.7202081,.321195,.147703,17.95557
24070,43784,3678,5151,23082,28233,17096,7040,3124,21071,8149,3317,3975,1109,193,2793,.7593801,.7716948,.215298,.0374685,.7406637,.3049996,.1353436,22.45107
24071,29908,2419,4075,15448,19523,11269,4693,2201,14157,5620,2350,2888,927,149,1683,.6957421,.7087117,.2274847,.0365644,.7294796,.3037934,.142478,20.79708
24072,15448,1155,1613,9222,10835,5035,1631,755,6297,1994,822,1262,363,67,911,.7887446,.782393,.2250465,.0415375,.545977,.1768597,.0818694,30.50556
24073,108161,12279,21889,52685,74574,35296,15355,7647,54659,24684,8503,19363,9329,856,10341,.8421696,.8845996,.4261958,.0391064,.669944,.2914492,.1451457,29.39727
24074,30328,2378,4024,17228,21252,11912,4897,2336,15122,6172,2602,3210,1275,266,1841,.77418,.7977137,.3168489,.0661034,.6914325,.2842466,.1355932,19.00395
24075,11322,1215,2195,6101,8296,4036,1734,826,6090,2774,963,2054,1040,137,1119,.9209877,.9357631,.4738041,.0624146,.6615309,.2842157,.1353876,36.6125
24076,12920,917,1255,7749,9004,4542,1787,676,5516,2175,726,974,388,50,758,.8266085,.7760956,.3091633,.0398406,.5861402,.2306104,.0872371,35.87569
24077,24991,2009,2476,14345,16821,8061,2678,1208,9915,3145,1287,1854,467,79,1589,.7909408,.7487884,.1886107,.0319063,.5619379,.1866852,.0842105,45.75237
24078,5542,415,462,3498,3960,2017,747,277,2390,891,288,373,144,11,355,.8554217,.8073593,.3116883,.0238095,.5766152,.2135506,.0791881,42.10796
24079,19335,1423,2037,11358,13395,7264,2657,1133,8840,3069,1187,1576,412,54,1113,.7821504,.7736868,.2022582,.0265096,.6395492,.233932,.0997535,25.99414
24080,14192,1148,1443,8224,9667,4755,1904,897,5897,2161,943,1142,257,46,859,.7482578,.7914068,.1781012,.031878,.5781858,.2315175,.109071,36.12379
24081,18448,1507,2523,10419,12942,7107,2807,1204,9206,3578,1265,2099,771,61,1224,.8122097,.8319461,.3055886,.0241776,.6821192,.2694117,.1155581,25.44125
24082,113571,9367,12584,61334,73918,50860,24148,12491,60717,27191,12997,9857,3043,506,7192,.7678019,.7832962,.241815,.0402098,.8292301,.3937131,.2036554,10.55963
24083,12361,824,1317,7674,8991,4619,1593,697,5637,1946,735,1018,353,38,639,.7754855,.7729689,.2680334,.0288535,.6019025,.2075841,.0908262,30.84529
24084,8454,726,992,4903,5895,3043,1347,479,3855,1669,499,812,322,20,608,.8374656,.8185484,.3245968,.0201613,.6206404,.2747298,.0976953,28.50536
24085,46256,4959,9125,24918,34043,16479,7937,4087,24636,12285,4453,8157,4348,366,4058,.8183101,.8939178,.4764931,.0401096,.6613292,.3185247,.164018,23.10822
24086,58681,4566,6551,31277,37828,21609,7393,3172,26699,8607,3381,5090,1214,209,3361,.7360929,.7769806,.1853152,.0319035,.6908911,.2363718,.1014164,26.04254
24087,13653,1172,1681,8222,9903,4951,1840,689,6323,2278,738,1372,438,49,902,.7696246,.8161808,.2605592,.0291493,.6021649,.2237898,.0837996,38.65669
25001,38035,3247,4672,21206,25878,11890,5597,2653,15089,6824,2889,3199,1227,236,2242,.6904835,.6847175,.2626284,.0505137,.5606903,.2639347,.1251061,44.93089
25002,33036,2258,3558,19521,23079,9680,3672,1699,12010,4407,1868,2330,735,169,1400,.6200177,.6548623,.2065767,.0474986,.4958762,.1881051,.0870345,50.22985
25003,13369,1047,1474,7454,8928,3362,1355,583,4305,1693,627,943,338,44,688,.6571156,.6397558,.229308,.0298507,.451033,.1817816,.078213,64.47763
25004,19865,1494,2056,11676,13732,5193,2068,1006,6276,2372,1047,1083,304,41,906,.6064257,.526751,.1478599,.0199416,.4447585,.1771155,.0861596,61.2204
25005,8153,713,1002,4405,5407,1715,590,269,2137,748,289,422,158,20,383,.5371669,.4211577,.1576846,.0199601,.3893303,.1339387,.061067,72.92594
25006,45965,4316,6392,22108,28500,10125,5717,3123,14172,8023,3417,4047,2306,294,3237,.75,.6331351,.3607635,.045995,.457979,.2585942,.1412611,72.00255
25007,15664,1188,1795,9119,10914,4134,1440,670,5190,1742,739,1056,302,69,754,.6346802,.5883008,.1682451,.0384401,.4533392,.157912,.073473,58.74469
25008,9776,770,1080,5521,6601,2227,851,403,2782,1019,429,555,168,26,563,.7311688,.5138889,.1555556,.0240741,.4033689,.1541387,.072994,78.23111
25009,17853,1271,1963,9901,11864,4670,1679,799,5656,2085,870,986,406,71,758,.5963808,.5022924,.2068263,.0361691,.4716695,.1695788,.0806989,56.76508
25010,8996,705,939,5055,5994,2260,801,356,2795,967,400,535,166,44,527,.7475177,.5697551,.1767838,.0468584,.4470821,.158457,.0704253,68.30823
25011,12279,1472,2623,5879,8502,2890,1625,1002,5091,2852,1076,2201,1227,74,1278,.8682065,.8391155,.467785,.028212,.4915802,.2764075,.1704371,73.88206
25012,16945,1288,1867,9675,11542,4510,1506,625,5740,1832,683,1230,326,58,785,.609472,.6588109,.1746117,.0310659,.4661499,.1556589,.0645995,65.73821
25013,21082,1838,2879,11187,14066,5590,2215,1187,7600,2948,1327,2010,733,140,1253,.6817192,.6981591,.2546023,.048628,.4996871,.1979977,.1061053,56.83925
25014,36918,3247,4442,18728,23170,8202,4555,2265,10622,5748,2407,2420,1193,142,2252,.6935633,.5447996,.2685727,.0319676,.4379539,.2432187,.1209419,64.68443
25015,26503,2580,3695,14283,17978,6727,3057,1205,9352,4329,1346,2625,1272,141,1917,.7430233,.7104195,.344249,.0381597,.4709795,.2140307,.084366,63.18005
25016,15927,1210,1745,8774,10519,3898,1619,649,4929,1964,690,1031,345,41,714,.5900826,.5908309,.1977077,.0234957,.4442672,.1845224,.0739685,58.76339
25017,53930,4695,5636,28786,34422,16698,5893,2196,20321,6875,2317,3623,982,121,3264,.6952077,.6428318,.174237,.0214691,.5800737,.2047176,.0762871,66.87966
25018,66018,5764,12808,34835,47643,22098,11454,6169,32898,17992,7319,10800,6538,1150,4256,.7383761,.843223,.5104622,.0897876,.634362,.3288072,.177092,39.81928
25019,8208,581,882,4773,5655,2312,780,292,2812,996,313,500,216,21,394,.6781411,.5668934,.244898,.0238095,.4843914,.1634192,.0611775,57.93793
25020,15297,1275,1697,8233,9930,4458,1350,534,5637,1641,580,1179,291,46,752,.5898039,.6947554,.1714791,.0271067,.5414794,.1639743,.0648609,46.12342
25021,9827,697,1110,5277,6387,2637,817,377,3342,975,409,705,158,32,418,.599713,.6351351,.1423423,.0288288,.4997157,.1548228,.0714421,70.54293
25022,21043,1648,2480,11694,14174,5756,2476,1175,7007,2965,1264,1251,489,89,1094,.6638349,.5044355,.1971774,.0358871,.4922182,.2117325,.1004789,55.7858
25023,24537,1961,2611,13947,16558,8172,3355,1512,9882,3981,1637,1710,626,125,1326,.6761856,.6549215,.2397549,.0478744,.5859324,.2405535,.1084104,49.2997
25024,157665,14876,26005,83659,109664,56659,26628,11648,76428,32603,12589,19769,5975,941,7236,.4864211,.7602,.2297635,.0361854,.6772612,.3182921,.1392319,33.21518
25025,250998,20627,38458,136788,175246,95749,58123,31927,126817,75784,36051,31068,17661,4124,15684,.7603626,.8078423,.4592282,.1072339,.699981,.424913,.233405,36.69951
25026,22970,2361,2865,11531,14396,4567,2325,1185,6305,2919,1246,1738,594,61,1877,.7950021,.6066318,.2073298,.0212914,.3960628,.2016304,.1027665,73.45987
25027,13931,1265,1675,6831,8506,2644,1391,622,3443,1762,707,799,371,85,813,.6426877,.4770149,.2214925,.0507463,.387059,.2036305,.0910555,76.97984
25028,2513,216,321,1238,1559,469,155,71,639,198,75,170,43,4,157,.7268519,.529595,.1339564,.0124611,.3788368,.1252019,.0573506,81.57027
25029,20518,1631,2394,12195,14589,4792,1845,701,6407,2390,753,1615,545,52,1138,.6977314,.6746032,.2276525,.021721,.3929479,.1512915,.0574826,49.01651
25030,118015,9676,15356,61821,77177,41730,17504,6993,52401,20684,7557,10671,3180,564,6393,.6607069,.6949075,.2070852,.0367283,.6750134,.28314,.1131169,27.54323
25031,17265,1346,1935,9544,11479,4812,1925,815,6019,2273,908,1207,348,93,996,.7399703,.6237726,.179845,.048062,.5041911,.2016974,.085394,61.97041
25032,9181,832,1163,4633,5796,1684,743,382,2415,1020,458,731,277,76,617,.7415866,.6285468,.2381771,.0653482,.3634794,.1603712,.082452,79.83694
25033,13846,1098,1502,7436,8938,3289,1390,591,4241,1752,643,952,362,52,773,.7040073,.6338215,.241012,.0346205,.4423077,.1869285,.0794782,66.91789
25034,61912,4938,7819,36040,43859,19947,9132,3628,25139,11221,3941,5192,2089,313,3340,.6763872,.6640235,.2671697,.0400307,.5534683,.2533851,.1006659,39.42144
25035,10148,816,1159,5585,6744,2536,1073,415,3182,1336,450,646,263,35,576,.7058824,.557377,.2269198,.0301984,.4540734,.1921218,.0743062,74.87743
25036,31030,3010,7857,15794,23651,9563,5685,3655,16701,10747,4575,7138,5062,920,2421,.804319,.9084892,.6442662,.117093,.6054831,.3599468,.231417,53.68322
25037,23821,1883,3041,12787,15828,7868,3667,1755,9971,4644,1985,2103,977,230,1338,.7105682,.6915488,.3212759,.075633,.6153124,.2867756,.1372488,47.45563
25038,77285,6087,10253,43851,54104,26599,11995,4759,34050,14967,5402,7451,2972,643,3670,.6029243,.7267141,.2898664,.0627134,.6065768,.2735399,.1085266,42.17578
25039,12518,901,1494,6846,8340,3370,1235,529,4250,1452,564,880,217,35,555,.6159822,.5890228,.1452477,.023427,.4922583,.1803973,.0772714,58.46304
25040,18790,1402,2014,10962,12976,4862,1817,726,5946,2148,807,1084,331,81,842,.6005706,.5382324,.1643496,.0402185,.4435322,.1657544,.0662288,65.489
25041,57061,4116,6533,32743,39276,19224,8857,4109,23513,10528,4502,4289,1671,393,2650,.643829,.6565131,.2557783,.0601561,.5871179,.2705006,.1254925,42.94575
25042,41525,3872,6169,21009,27178,9391,5083,2766,13731,7273,3075,4340,2190,309,2930,.7567149,.7035176,.3550008,.0500892,.4469989,.2419439,.1316579,64.14461
25043,30174,2088,3320,17099,20419,9366,4265,1731,11433,4985,1812,2067,720,81,1449,.6939655,.6225904,.2168675,.0243976,.5477513,.2494298,.101234,48.06483
25044,57304,4802,9145,29789,38934,17242,8508,4487,23898,11539,5116,6656,3031,629,3222,.6709704,.7278294,.3314379,.0687808,.5788043,.2856088,.1506261,45.12955
25045,41613,3581,5639,21495,27134,11829,6566,3578,15683,8538,4052,3854,1972,474,2577,.7196314,.6834545,.3497074,.0840575,.550314,.3054664,.1664573,67.58493
25046,25708,1984,2944,14295,17239,7017,2625,1190,8924,3202,1324,1907,577,134,1247,.6285282,.6477581,.1959918,.0455163,.4908709,.1836306,.0832459,53.54998
25047,29296,2843,3974,14797,18771,6426,2656,1374,8957,3680,1462,2531,1024,88,1873,.6588111,.6368898,.2576749,.0221439,.4342772,.1794958,.0928567,73.2767
25048,36404,2888,4023,20533,24556,9508,3297,1387,11831,4036,1491,2323,739,104,1759,.609072,.5774298,.1836938,.0258514,.4630595,.1605708,.0675498,49.59949
25049,13366,1069,1415,7823,9238,3350,1284,529,4201,1626,586,851,342,57,694,.6492049,.6014134,.2416961,.0402827,.4282245,.1641314,.0676211,62.41289
25050,23789,1653,2389,13621,16010,6505,2585,1215,7960,3035,1271,1455,450,56,999,.6043557,.6090415,.1883633,.0234408,.4775714,.1897805,.0892005,58.3302
25051,19944,1614,2387,11753,14140,6232,2610,1011,7935,3230,1070,1703,620,59,1153,.7143742,.7134479,.2597403,.0247172,.5302476,.222071,.0860206,56.42608
25052,13212,1085,1599,6795,8394,2692,1240,595,3581,1467,628,889,227,33,704,.6488479,.5559725,.1419637,.0206379,.3961737,.1824871,.0875644,73.9986
25053,36018,4420,10761,15745,26506,10146,6831,4454,19894,14011,5420,9748,7180,966,3759,.8504525,.9058638,.6672242,.0897686,.6443951,.433852,.2828835,56.30774
25054,28164,2369,3192,15075,18267,6172,2631,1163,7992,3352,1273,1820,721,110,1574,.6644154,.5701754,.2258772,.0344612,.4094196,.1745274,.0771476,69.29785
25055,33795,2957,4014,18617,22631,10834,4126,1760,13458,5179,1884,2624,1053,124,2118,.7162665,.653712,.2623318,.0308919,.5819412,.2216254,.0945373,46.30777
25056,9864,818,1119,5280,6399,2887,945,357,3728,1159,387,841,214,30,540,.6601467,.7515639,.1912422,.0268097,.5467803,.1789773,.0676136,59.89767
25057,36173,2862,4238,20201,24439,10895,5016,2350,13691,6032,2507,2796,1016,157,2013,.7033543,.6597452,.2397357,.0370458,.5393297,.2483045,.1163309,53.07844
25058,20918,1530,2256,12279,14535,5717,2038,860,7148,2524,941,1431,486,81,1016,.6640523,.6343085,.2154255,.0359043,.4655917,.1659744,.0700383,60.14148
25059,24025,1881,2919,13938,16857,6113,2362,963,8098,3179,1063,1985,817,100,1409,.7490696,.6800274,.2798904,.0342583,.4385852,.1694648,.0690917,59.266
25060,12636,1041,1346,6522,7868,2382,1142,535,3085,1453,587,703,311,52,747,.7175792,.5222883,.231055,.038633,.3652254,.1750997,.0820301,73.61789
25061,69427,4996,7744,39001,46745,25128,11861,5497,30430,14012,5919,5302,2151,422,3143,.6291033,.6846591,.2777634,.0544938,.6442912,.3041204,.1409451,43.05924
25062,24556,1878,2716,13574,16290,6163,2307,1112,7824,2827,1169,1661,520,57,1083,.5766773,.6115611,.191458,.0209867,.4540298,.1699573,.0819213,60.84792
25063,7964,684,982,3889,4871,1643,871,519,2151,1012,546,508,141,27,502,.7339181,.5173116,.1435845,.0274949,.4224736,.223965,.1334533,72.37075
25064,23441,1777,2579,13217,15796,6605,2441,984,8235,3006,1047,1630,565,63,1096,.6167699,.6320279,.2190772,.0244281,.4997352,.1846864,.0744496,58.10296
25065,15077,1092,1745,8615,10360,4340,1589,638,5420,1897,719,1080,308,81,606,.5549451,.6189111,.1765043,.0464183,.5037725,.1844457,.0740569,58.94094
25066,9716,1152,1560,5163,6723,3031,1297,589,4276,1744,609,1245,447,20,855,.7421875,.7980769,.2865385,.0128205,.5870618,.2512105,.114081,49.56522
25067,34844,2949,4781,17634,22415,7241,3987,1986,9792,5136,2180,2551,1149,194,2031,.688708,.5335704,.2403263,.0405773,.4106272,.2260973,.1126233,71.1115
25068,17157,1476,1880,8842,10722,3259,1465,756,4208,1853,776,949,388,20,941,.6375339,.5047872,.206383,.0106383,.3685818,.1656865,.085501,75.83963
25069,20119,2302,3195,10409,13604,5178,2362,960,7536,3260,1070,2358,898,110,1803,.783232,.7380282,.2810642,.0344288,.4974541,.226919,.0922279,68.06315
25070,18739,1387,2152,10867,13019,4942,1634,701,6328,2083,759,1386,449,58,890,.6416727,.644052,.2086431,.0269517,.4547713,.1503635,.0645072,55.21193
25071,18434,1265,1963,11340,13303,5149,1736,633,6405,2117,692,1256,381,59,794,.627668,.639837,.1940907,.030056,.4540564,.1530864,.0558201,53.61285
25072,9652,826,1134,4581,5715,1413,706,299,1933,912,343,520,206,44,546,.6610169,.4585538,.1816579,.0388007,.3084479,.1541148,.0652696,77.81367
25073,21741,1382,2261,13060,15321,6058,2315,1146,7445,2800,1228,1387,485,82,832,.602026,.6134454,.2145068,.0362671,.4638591,.1772588,.0877488,58.71204
25074,13761,1005,1485,7556,9041,3626,1465,682,4421,1730,722,795,265,40,629,.6258706,.5353535,.1784512,.026936,.4798835,.1938857,.0902594,59.64688
25075,51627,3864,6102,28389,34491,16900,8651,4462,20846,10446,4869,3946,1795,407,2768,.7163561,.6466732,.2941658,.0666994,.595301,.3047307,.1571736,47.28231
25076,72344,5690,8505,37038,45543,18507,9224,4640,23388,11187,5066,4881,1963,426,3767,.6620387,.5738977,.2308054,.0500882,.499676,.2490415,.1252767,55.09047
25077,19135,1582,2363,10112,12475,4635,1837,752,6090,2321,862,1455,484,110,1001,.6327434,.6157427,.2048244,.046551,.4583663,.1816653,.0743671,61.14566
25078,10300,697,1120,6243,7363,3037,1008,423,3788,1290,453,751,282,30,516,.7403156,.6705357,.2517857,.0267857,.4864648,.1614608,.0677559,65.13288
25079,10021,859,1146,5591,6737,2445,889,481,3050,1033,505,605,144,24,619,.7206054,.5279232,.1256544,.0209424,.43731,.1590055,.0860311,70.66877
25080,19474,1356,2005,11218,13223,5236,2240,946,6505,2631,1027,1269,391,81,917,.6762537,.6329177,.1950125,.040399,.4667499,.1996791,.0843288,56.54118
25081,13139,1010,1408,7649,9057,3473,1245,613,4316,1528,638,843,283,25,657,.6504951,.5987216,.2009943,.0177557,.4540463,.1627664,.0801412,59.86822
25082,27349,2184,3105,14817,17922,6886,3417,1702,8613,4146,1774,1727,729,72,1580,.7234432,.5561997,.2347826,.0231884,.4647365,.2306135,.1148681,62.03357
26001,24870,3058,6555,12774,19329,8624,4353,2557,14638,8167,3208,6014,3814,651,2600,.8502289,.9174676,.5818459,.0993135,.6751214,.3407703,.2001722,34.61273
26002,13980,962,1489,8442,9931,5537,1724,883,6693,2028,948,1156,304,65,634,.6590437,.77636,.2041639,.0436535,.6558872,.204217,.1045961,32.27605
26003,8605,588,939,5445,6384,3630,1351,641,4330,1659,677,700,308,36,440,.7482993,.7454739,.3280085,.0383387,.6666667,.2481175,.1177227,33.88495
26004,26458,1917,2892,15993,18885,9760,3014,1533,11734,3463,1669,1974,449,136,1271,.6630151,.6825726,.1552559,.0470263,.610267,.1884574,.0958544,24.69141
26005,24408,1688,2275,15553,17828,8872,2667,1092,10448,2966,1176,1576,299,84,1049,.6214455,.6927472,.1314286,.0369231,.5704366,.1714782,.0702115,42.26244
26006,11292,718,1173,7167,8340,4048,1199,502,4924,1411,545,876,212,43,466,.6490251,.746803,.1807332,.0366581,.5648109,.1672945,.0700433,39.70561
26007,15873,1083,1471,10176,11647,5871,1669,742,6943,1845,789,1072,176,47,712,.657433,.728756,.1196465,.0319511,.5769458,.1640134,.0729167,33.92316
26008,12183,764,991,8223,9214,4128,1218,518,4837,1372,539,709,154,21,467,.6112565,.715439,.1553986,.0211907,.5020066,.1481211,.062994,38.55001
26009,10301,680,1030,6271,7301,2534,613,307,3254,720,325,720,107,18,423,.6220588,.6990291,.1038835,.0174757,.4040823,.0977516,.0489555,51.47935
26010,100376,11280,28281,49543,77824,39472,25425,17168,65374,43421,20636,25902,17996,3468,9668,.8570922,.9158799,.6363283,.1226265,.7967221,.5131906,.3465272,21.83126
26011,87888,6534,11160,52864,64024,33528,12636,5629,42043,15669,6100,8515,3033,471,4057,.6209061,.7629929,.2717742,.0422043,.6342312,.2390285,.1064808,18.86342
26012,37693,2722,3913,23149,27062,11166,4013,1889,13778,4831,2015,2612,818,126,1790,.6576047,.6675186,.2090468,.0322004,.4823534,.1733552,.0816018,49.58583
26013,8660,620,770,5532,6302,3420,953,368,4010,1064,398,590,111,30,433,.6983871,.7662337,.1441558,.038961,.6182213,.1722704,.0665221,40
26014,32252,2813,4914,18215,23129,10839,4321,2126,14580,5802,2257,3741,1481,131,2010,.7145396,.7612942,.3013838,.0266585,.595059,.2372221,.116717,27.24039
26015,20017,1173,1854,13380,15234,8171,2836,1167,9477,3130,1238,1306,294,71,747,.6368287,.7044229,.1585761,.0382956,.6106876,.2119581,.0872197,41.62876
26016,58837,5502,11180,33047,44227,21089,10175,5648,30639,15377,6211,9550,5202,563,4377,.7955289,.8542039,.4652952,.0503578,.6381517,.3078948,.1709081,27.19163
26017,12131,765,1197,7679,8876,4450,1280,620,5303,1492,683,853,212,63,562,.7346405,.7126149,.1771094,.0526316,.5795025,.1666884,.0807397,35.64886
26018,5428,369,524,3253,3777,1469,491,234,1784,520,257,315,29,23,257,.6964769,.601145,.0553435,.0438931,.4515831,.1509376,.0719336,56.36758
26019,51029,3795,5566,29065,34631,20344,7106,2962,24418,7976,3156,4074,870,194,2429,.6400527,.731944,.1563061,.0348545,.6999484,.2444865,.1019095,25.39486
26020,11894,656,985,8047,9032,4191,1140,506,4961,1263,514,770,123,8,443,.6753049,.7817259,.1248731,.0081218,.5208152,.1416677,.0628806,40.8512
26021,10489,709,1023,6775,7798,3984,1081,515,4731,1231,545,747,150,30,482,.6798307,.7302053,.1466276,.0293255,.5880443,.1595572,.0760148,39
26022,22402,1595,2410,13077,15487,8399,2702,1048,10308,3126,1141,1909,424,93,1135,.7115988,.7921162,.1759336,.0385892,.6422727,.2066223,.0801407,37.08989
26023,8493,630,885,5079,5964,3017,753,288,3654,865,301,637,112,13,373,.5920635,.719774,.1265537,.0146893,.5940146,.1482575,.0567041,34.74439
26024,136488,10520,17789,80083,97872,61407,26457,12374,75587,31914,13895,14180,5457,1521,7568,.7193916,.7971218,.3067626,.0855023,.7667919,.3303697,.1545147,9.505135
26025,15916,1087,1498,9502,11000,6475,2218,858,7630,2504,917,1155,286,59,718,.6605336,.771028,.1909212,.0393858,.6814355,.2334245,.0902968,31.69861
26026,56663,3778,8036,33085,41121,23180,11447,6397,29109,13746,6911,5929,2299,514,2670,.7067232,.7378049,.2860876,.0639622,.7006196,.3459876,.1933505,19.65229
26027,14643,1230,1597,8963,10560,5472,1861,946,6666,2160,1005,1194,299,59,684,.5560976,.7476519,.187226,.0369443,.6105099,.2076314,.105545,29.23992
26028,18300,1317,1960,11036,12996,5132,1651,783,6319,1854,836,1187,203,53,677,.5140471,.6056122,.1035714,.0270408,.4650235,.1496013,.0709496,38.21468
26029,7383,473,640,4941,5581,2864,823,354,3380,924,377,516,101,23,335,.7082452,.80625,.1578125,.0359375,.5796397,.1665655,.0716454,48.62715
26030,12096,731,1056,7654,8710,3926,1047,433,4648,1165,464,722,118,31,502,.6867305,.6837121,.1117424,.0293561,.5129344,.1367912,.0565717,48.68559
26031,8905,581,857,5622,6479,3344,911,402,3913,1044,444,569,133,42,387,.6660929,.663944,.1551925,.0490082,.5948061,.162042,.0715048,40.26553
26032,8222,581,824,5187,6011,3328,950,408,3947,1087,426,619,137,18,380,.6540447,.7512136,.1662621,.0218447,.641604,.1831502,.0786582,36.38796
26033,14517,1095,1590,8917,10507,3996,1206,596,4883,1373,601,887,167,5,680,.6210046,.5578616,.1050314,.0031447,.4481328,.1352473,.0668386,43.20271
26034,11594,845,1130,7135,8265,3397,1021,475,4103,1084,482,706,63,7,499,.5905325,.6247787,.0557522,.0061947,.4761037,.1430974,.0665732,54.64905
26035,36324,2730,3644,21677,25321,9119,2957,1457,11452,3259,1526,2333,302,69,1696,.6212454,.6402305,.082876,.0189352,.4206763,.1364119,.0672141,51.5459
26036,71233,5593,8379,40054,48433,21036,6327,2980,27001,7737,3148,5965,1410,168,3753,.6710173,.7118988,.1682778,.0200501,.525191,.1579618,.0743996,22.14887
26037,13181,896,1308,8601,9909,4060,1145,623,4953,1322,669,893,177,46,553,.6171875,.6827217,.1353211,.0351682,.4720381,.1331241,.0724334,31.95566
26038,7887,486,757,5208,5965,3105,1019,482,3690,1127,515,585,108,33,304,.6255144,.7727873,.1426684,.0435931,.5961981,.1956605,.0925499,40.57971
26039,185302,15397,31080,106532,137612,75766,35047,16687,102364,48277,18443,26598,13230,1756,11862,.7704098,.8557915,.4256757,.0564994,.7112042,.328981,.1566384,24.54397
26040,11959,711,1139,7781,8920,4944,1806,686,5814,2085,749,870,279,63,468,.6582279,.7638279,.2449517,.0553117,.6353939,.2321038,.0881635,35.82857
26041,9890,635,1012,6506,7518,3997,1115,487,4752,1293,523,755,178,36,430,.6771653,.7460474,.1758893,.0355731,.614356,.1713803,.074854,45.41972
26042,19672,1272,1824,12647,14471,7390,2351,1065,8734,2658,1152,1344,307,87,817,.6422956,.7368421,.1683114,.0476974,.5843283,.1858939,.0842097,33.50625
26043,6367,337,414,4465,4879,2371,647,256,2632,680,266,261,33,10,226,.6706231,.6304348,.0797101,.0241546,.531019,.1449048,.0573348,50.11302
26044,6882,380,568,4555,5123,2975,840,356,3429,947,383,454,107,27,266,.7,.7992958,.1883803,.0475352,.6531284,.1844127,.0781559,35.62452
26045,10008,873,1361,6054,7415,3486,1225,672,4686,1765,768,1200,540,96,671,.768614,.8817046,.3967671,.0705364,.5758176,.2023456,.111001,35.62199
26046,28807,2101,2887,17850,20737,9246,2995,1357,11320,3419,1409,2074,424,52,1356,.645407,.7183928,.1468653,.0180118,.5179832,.1677871,.0760224,45.32809
26047,11084,684,1035,6710,7745,3236,933,521,3825,1102,570,589,169,49,475,.6944444,.5690821,.163285,.047343,.4822653,.1390462,.0776453,45.8444
26048,629266,44259,81264,377106,458370,266613,122073,59179,327766,145191,65080,61153,23118,5901,28409,.6418808,.7525226,.2844802,.0726152,.7069975,.3237101,.1569294,16.75953
26049,86958,6162,11041,52494,63535,32471,13057,5732,40597,16012,6259,8126,2955,527,3936,.6387537,.7359841,.2676388,.0477312,.6185659,.2487332,.1091934,29.29652
26050,146183,11099,17483,80141,97624,47597,15195,5847,59908,18169,6294,12311,2974,447,7468,.6728534,.7041698,.1701081,.0255677,.5939157,.1896033,.0729589,16.20752
26051,39059,5025,11043,18425,29468,13284,6354,3466,23565,11626,4010,10281,5272,544,3875,.7711443,.930997,.4774065,.049262,.7209769,.3448575,.188114,29.06941
26052,5508,371,515,3501,4016,2175,612,281,2558,713,313,383,101,32,230,.6199461,.7436893,.1961165,.0621359,.621251,.1748072,.0802628,36.62251
26053,24323,1755,2464,14718,17182,8129,2338,1128,9747,2651,1279,1618,313,151,1088,.619943,.6566558,.1270292,.0612825,.5523169,.1588531,.0766408,42.14335
26054,29925,2159,3128,18559,21687,11294,3685,1748,13701,4233,1880,2407,548,132,1504,.6966188,.7695013,.1751918,.0421995,.6085457,.198556,.0941861,27.47041
26055,28973,1920,2779,17864,20643,10502,3322,1439,12569,3703,1546,2067,381,107,1230,.640625,.7437927,.1370997,.0385031,.5878863,.1859606,.0805531,33.97565
26056,10901,923,1450,6410,7860,4106,1281,589,5309,1738,647,1203,457,58,638,.6912243,.8296552,.3151724,.04,.6405616,.199844,.0918877,30.91975
26057,22193,1646,2388,13088,15476,6897,1722,746,8502,2004,816,1605,282,70,1112,.6755772,.6721106,.1180905,.0293132,.5269713,.1315709,.0569988,30.22553
26058,15495,981,1528,10303,11831,6384,1711,804,7416,1943,832,1032,232,28,662,.6748216,.6753927,.1518325,.0183246,.6196253,.1660681,.0780355,35.65388
26059,15739,1009,1559,9867,11426,6316,2145,865,7471,2412,935,1155,267,70,692,.6858276,.7408595,.1712636,.0449006,.6401135,.2173913,.087666,36.54527
26060,14917,1137,1563,9015,10578,5011,1519,621,5911,1688,635,900,169,14,708,.6226913,.5758157,.1081254,.0089571,.5558513,.168497,.0688852,50.33413
26061,16313,1003,1480,10501,11981,6136,1892,914,7362,2199,987,1226,307,73,673,.670987,.8283784,.2074324,.0493243,.5843253,.1801733,.0870393,35.36033
26062,10725,724,1034,6816,7850,2877,858,425,3569,1018,474,692,160,49,531,.7334254,.6692457,.1547389,.0473888,.4220951,.1258803,.0623533,38.1367
26063,7551,599,747,4689,5436,2200,536,256,2725,635,267,525,99,11,376,.6277128,.7028112,.1325301,.0147256,.4691832,.1143101,.0545959,42.51155
26064,28638,1970,3259,17452,20711,10725,3883,1910,13066,4561,2017,2341,678,107,1262,.6406091,.7183185,.2080393,.0328322,.6145427,.222496,.109443,27.1885
26065,4685,279,458,3163,3621,1889,500,242,2253,603,257,364,103,15,198,.7096774,.7947598,.2248908,.0327511,.5972179,.1580778,.0765096,41.74825
26066,18532,1263,1908,11217,13125,6032,1930,821,7357,2201,900,1325,271,79,769,.6088678,.6944444,.1420335,.0414046,.5377552,.1720603,.0731925,37.94578
26067,15726,1244,1576,9026,10602,3748,1226,634,4670,1412,672,922,186,38,812,.6527331,.5850254,.1180203,.0241117,.4152448,.1358298,.0702415,56.15516
26068,12068,836,1258,7406,8664,4115,1363,614,5087,1578,671,972,215,57,532,.6363636,.772655,.1709062,.04531,.5556306,.18404,.0829058,36.82827
26069,9716,673,1050,5967,7017,3586,995,400,4357,1183,447,771,188,47,504,.7488856,.7342857,.1790476,.0447619,.600972,.1667505,.0670354,40.08276
26070,11537,821,1130,7178,8308,3657,1065,430,4376,1254,478,719,189,48,525,.6394641,.6362832,.1672566,.0424779,.5094734,.14837,.0599053,35.97599
26071,13807,999,1175,9117,10292,4820,1421,602,5585,1584,631,765,163,29,565,.5655656,.6510639,.1387234,.0246809,.5286827,.1558627,.0660305,40.41253
26072,22945,1805,2386,12944,15330,5409,1756,893,6822,1995,927,1413,239,34,1213,.6720222,.5922045,.1001676,.0142498,.417877,.1356613,.0689895,62.59502
26073,40555,3144,4417,24428,28845,15466,5675,2328,18708,6776,2523,3242,1101,195,2253,.716603,.7339823,.2492642,.0441476,.6331259,.2323154,.0953005,31.9477
26074,21996,2234,4665,11917,16582,8533,3724,1944,12800,5934,2233,4267,2210,289,1843,.8249776,.9146838,.4737406,.0619507,.7160359,.3124948,.1631283,37.57999
26075,10238,677,879,6463,7342,3191,919,390,3776,1052,425,585,133,35,496,.732644,.665529,.1513083,.039818,.4937336,.142194,.0603435,51.93146
26076,12014,1060,1435,6716,8151,3272,939,449,4454,1138,466,1182,199,17,712,.6716981,.8236934,.138676,.0118467,.4871947,.1398154,.0668553,37.14078
26077,7961,508,710,5132,5842,2624,777,374,3093,812,385,469,35,11,321,.6318898,.6605634,.0492958,.015493,.5113016,.151403,.0728761,52.38928
26078,24987,1858,2538,14025,16563,5512,1828,923,7031,2152,985,1519,324,62,1151,.6194833,.5985028,.1276596,.0244287,.3930125,.1303387,.0658111,62.97789
26079,16784,1223,1850,9854,11704,4229,1142,551,5637,1387,613,1408,245,62,816,.6672118,.7610811,.1324324,.0335135,.4291658,.115892,.0559164,36.48815
26080,36378,2591,4318,22226,26544,13658,5050,2080,16748,6138,2232,3090,1088,152,1667,.6433809,.7156091,.2519685,.0352015,.6145055,.2272114,.0935841,28.26674
26081,33633,3504,7125,17939,25064,10919,4866,2679,17150,8434,3141,6231,3568,462,2806,.8007991,.8745263,.5007719,.0648421,.6086738,.2712526,.1493394,32.5816
26082,17568,1274,1807,10455,12262,5997,1997,971,7198,2288,1081,1201,291,110,857,.6726844,.6646375,.1610404,.0608744,.5736011,.1910091,.0928742,35.46789
26083,46341,3384,5439,26793,32232,21386,10354,5071,25747,11832,5519,4361,1478,448,2256,.6666667,.8018018,.2717411,.0823681,.7981936,.3864442,.1892658,14.79454
26084,18822,1662,2766,11163,13929,6463,2325,1090,8751,3289,1163,2288,964,73,1184,.7123947,.8271873,.3485177,.0263919,.5789662,.2082773,.097644,43.92852
26085,42011,8009,13050,17473,30523,11741,3852,1801,19861,5367,2080,8120,1515,279,1037,.1294793,.6222222,.116092,.0213793,.671951,.2204544,.1030733,33.63843
26086,6092,405,563,3949,4512,2060,552,223,2473,633,237,413,81,14,251,.6197531,.7335702,.1438721,.0248668,.521651,.1397822,.05647,51.56318
26087,8911,612,870,5436,6306,3207,857,400,3841,991,431,634,134,31,421,.6879085,.7287356,.154023,.0356322,.5899559,.1576527,.0735835,28.11375
26088,25460,1710,3080,15483,18563,9512,3502,1408,11463,4225,1517,1951,723,109,1044,.6105263,.6334416,.2347403,.0353896,.6143512,.2261836,.0909384,30.57927
26089,21378,1586,2111,12822,14933,7829,2140,959,9339,2423,1021,1510,283,62,1094,.6897856,.7153008,.1340597,.02937,.6105912,.1669006,.0747933,25.63301
26090,7230,548,747,4319,5066,1826,448,207,2298,511,234,472,63,27,308,.5620438,.6318608,.0843373,.0361446,.422783,.1037277,.0479278,49.8835
26091,12458,888,1169,7808,8977,2905,840,372,3621,1027,395,716,187,23,575,.6475225,.6124893,.1599658,.0196749,.3720543,.107582,.0476434,57.44408
26092,144107,10656,16980,78743,95723,56177,23232,10795,69455,26833,11474,13278,3601,679,7067,.6631944,.7819788,.212073,.0399882,.7134221,.2950357,.1370915,12.43386
26093,8622,578,735,5661,6396,2959,861,434,3486,922,460,527,61,26,382,.6608996,.7170068,.0829932,.0353741,.5226992,.1520933,.0766649,47.82911
26094,42600,3187,4645,25818,30463,13631,4590,2024,16831,5415,2144,3200,825,120,1994,.6256668,.6889128,.1776103,.0258342,.527965,.1777829,.0783949,29.5232
26095,973896,72217,117424,588975,706399,435105,233660,135086,528834,276681,146319,93729,43021,11233,55012,.7617597,.7982099,.3663732,.0956619,.7387495,.3967231,.2293578,6.881126
26096,453085,31788,60846,273572,334418,131928,57070,27380,170794,73049,31392,38866,15979,4012,21039,.6618536,.6387601,.2626138,.065937,.4822423,.2086105,.1000833,24.59961
26097,15180,1298,1771,8604,10375,4413,1084,534,5659,1315,557,1246,231,23,857,.6602466,.7035573,.1304348,.012987,.5129009,.1259879,.0620642,26.12272
26098,24919,1782,2836,15544,18380,8755,3293,1535,10697,3895,1684,1942,602,149,1160,.650954,.6847673,.2122708,.0525388,.5632398,.2118502,.0987519,27.67084
26099,4979,333,482,3177,3659,1902,500,226,2295,559,230,393,59,4,220,.6606607,.8153527,.1224066,.0082988,.598678,.1573812,.0711363,46.93097
26100,5415,358,506,3443,3949,2061,601,252,2415,691,272,354,90,20,259,.7234637,.6996047,.1778656,.0395257,.5986059,.1745571,.073192,34.45131
26101,39647,3117,4722,22487,27209,11567,3627,1730,14844,4387,1896,3277,760,166,1961,.6291306,.6939856,.1609488,.0351546,.5143861,.1612932,.0769333,37.76123
26102,7885,618,869,4748,5617,2159,519,279,2693,596,306,534,77,27,362,.5857605,.6144994,.0886076,.0310702,.4547178,.1093092,.0587616,56.29004
26103,7826,536,811,5011,5822,3042,825,342,3687,943,389,645,118,47,367,.6847015,.7953144,.1454994,.0579531,.6070645,.1646378,.0682499,34.2003
26104,29009,2238,2962,17817,20779,8223,2276,1190,10079,2549,1255,1856,273,65,1318,.5889187,.6266037,.0921675,.0219446,.4615255,.1277432,.0667901,48.22536
26105,15587,911,1186,10550,11736,6538,2428,1195,7344,2555,1219,806,127,24,617,.6772777,.6795953,.1070826,.0202361,.6197156,.2301422,.1132701,42.69717
26106,7434,475,663,4931,5594,2694,727,312,3185,802,323,491,75,11,346,.728421,.7405732,.1131222,.0165913,.5463395,.1474346,.0632732,39.64244
26107,20467,1576,2502,13542,16044,8863,3421,1704,10946,4248,1801,2083,827,97,1184,.751269,.832534,.3305356,.038769,.6544824,.2526215,.1258308,46.68357
26108,21070,1515,2052,12964,15016,6498,1841,860,8016,2098,938,1518,257,78,918,.6059406,.7397661,.1252437,.0380117,.5012342,.1420086,.0663375,43.01273
26109,19806,1406,2126,12396,14522,7748,2599,1240,9348,3019,1303,1600,420,63,1001,.7119488,.752587,.1975541,.0296331,.6250404,.2096644,.1000323,33.31312
26110,14900,978,1562,9024,10586,4835,1492,692,5977,1755,723,1142,263,31,633,.6472393,.731114,.1683739,.0198463,.5357934,.1653369,.0766844,26.17513
26111,17983,1365,1936,9870,11806,3842,942,414,5072,1216,476,1230,274,62,827,.6058608,.6353306,.1415289,.0320248,.3892604,.0954407,.0419453,45.95241
26112,11277,846,1083,7225,8308,2597,646,290,3264,747,313,667,101,23,487,.5756501,.6158818,.0932595,.0212373,.3594464,.0894118,.0401384,60.09212
26113,20414,1471,2141,11763,13904,6541,1963,794,7951,2230,830,1410,267,36,907,.6165873,.6585708,.1247081,.0168146,.5560656,.1668792,.0674998,47.65557
26114,3008,189,225,2006,2231,1222,411,212,1401,463,222,179,52,10,167,.8835979,.7955555,.2311111,.0444444,.6091725,.2048853,.105683,40.97735
26115,16188,1182,1614,9903,11517,4661,1266,591,5692,1421,641,1031,155,50,700,.5922166,.6387856,.0960347,.0309789,.4706655,.12784,.0596789,48.68207
27001,8186,671,1154,4681,5835,3550,1949,868,4489,2353,910,939,404,42,488,.7272727,.8136915,.3500867,.0363951,.7583849,.416364,.1854305,20.44492
27002,11096,922,1379,5684,7063,3698,1698,727,4605,1955,764,907,257,37,605,.6561822,.657723,.1863669,.026831,.6505982,.2987333,.1279029,34.61918
27003,6999,551,810,3784,4594,2592,1248,526,3107,1411,560,515,163,34,419,.7604356,.6358024,.2012346,.0419753,.6849895,.3298097,.1390063,34.65196
27004,3267,219,330,1929,2259,1401,542,229,1650,587,245,249,45,16,163,.7442923,.7545455,.1363636,.0484848,.7262831,.2809746,.1187144,24.29765
27005,8099,466,647,5210,5857,3624,1688,684,4107,1804,713,483,116,29,348,.7467811,.7465224,.179289,.0448223,.6955854,.3239923,.131286,23.24582
27006,1799,151,164,1132,1296,797,341,142,936,385,156,139,44,14,113,.7483444,.847561,.2682927,.0853659,.7040636,.3012367,.1254417,27.59051
27007,80696,6432,11547,45588,57135,34304,15911,7922,43405,18423,8514,9101,2512,592,4185,.650653,.7881701,.2175457,.0512687,.7524787,.3490173,.1737738,14.10478
27008,6092,416,593,3707,4300,2845,1318,605,3294,1506,648,449,188,43,341,.8197116,.7571669,.317032,.0725126,.767467,.3555436,.1632047,18.46997
27009,13109,1162,1586,7654,9240,5300,2819,1172,6496,3261,1238,1196,442,66,818,.7039587,.7540984,.2786885,.0416141,.6924484,.3683042,.1531225,20.32288
27010,2835,189,213,1801,2014,1191,542,233,1368,594,237,177,52,4,144,.7619048,.8309859,.2441315,.0187793,.6612993,.3009439,.1293726,29.99196
27011,11805,894,1711,6445,8156,4596,1959,844,6062,2436,902,1466,477,58,534,.5973154,.8568089,.2787843,.0338983,.7131109,.3039566,.1309542,20.01818
27012,12518,1081,1299,7622,8921,5100,2186,845,5999,2463,885,899,277,40,644,.5957447,.6920708,.213241,.0307929,.6691157,.2868014,.1108633,19.97916
27013,3763,291,447,2114,2561,1346,488,193,1729,543,214,383,55,21,209,.7182131,.8568233,.1230425,.0469799,.6367077,.230842,.0912961,22.79245
27014,13076,919,1357,8003,9360,5805,2492,1120,6857,2908,1173,1052,416,53,728,.7921654,.7752395,.3065586,.0390567,.725353,.3113832,.1399475,23.71851
27015,51966,3548,5696,30577,36273,23520,11406,4713,27981,12705,4934,4461,1299,221,2320,.6538895,.7831812,.2280548,.0387992,.7692056,.3730255,.1541355,17.01123
27016,42865,4516,11102,21606,32708,18225,11988,6583,28650,18423,7299,10425,6435,716,3879,.858946,.93902,.5796253,.0644929,.8435157,.5548459,.3046839,18.32405
27017,1656,124,191,966,1157,704,286,108,852,333,120,148,47,12,87,.7016129,.7748691,.2460733,.0628272,.7287785,.2960663,.1118012,32.01947
27018,10628,813,1257,5646,6903,3831,1690,744,4620,1965,791,789,275,47,438,.5387454,.627685,.2187749,.0373906,.6785335,.299327,.1317747,36.44568
27019,1026,60,73,627,700,452,220,85,511,246,100,59,26,15,52,.8666667,.8082192,.3561644,.2054795,.7208931,.3508772,.1355662,32.93904
27020,2700,198,239,1669,1908,1186,552,242,1347,599,261,161,47,19,136,.6868687,.6736402,.1966527,.0794979,.7106051,.330737,.144997,16.53961
27021,17985,1508,2800,9730,12530,6950,3519,1647,9245,4379,1792,2295,860,145,1083,.7181697,.8196428,.3071429,.0517857,.7142857,.361665,.1692703,14.77028
27022,7029,553,639,4080,4719,2971,1368,727,3377,1468,739,406,100,12,387,.6998191,.6353678,.1564945,.0187793,.7281862,.3352941,.1781863,25.73134
27023,2646,188,230,1628,1858,1212,621,262,1395,681,272,183,60,10,157,.8351064,.7956522,.2608696,.0434783,.7444717,.3814496,.1609337,22.049
27024,19056,1380,1916,11046,12962,7907,3661,1598,9212,3999,1665,1305,338,67,1019,.7384058,.6811064,.1764092,.0349687,.7158247,.3314322,.1446678,30.51216
27025,43039,3428,5733,24842,30575,20456,10960,5936,25113,12745,6251,4657,1785,315,2551,.7441657,.8123147,.3113553,.0549451,.8234442,.4411883,.2389502,13.92966
27026,2329,183,254,1363,1617,937,457,193,1108,510,205,171,53,12,119,.6502732,.6732283,.2086614,.0472441,.6874542,.3352898,.1415994,15.8871
27027,17752,1361,1902,9901,11803,6818,2794,1130,8110,3044,1190,1292,250,60,938,.6891991,.679285,.1314406,.0315457,.6886173,.2821937,.1141299,15.70413
27028,2702,205,268,1522,1790,1058,468,189,1259,519,197,201,51,8,157,.7658536,.75,.1902985,.0298507,.695138,.3074901,.1241787,32.65113
27029,5448,326,486,3478,3964,2491,1149,539,2850,1289,586,359,140,47,222,.6809816,.7386831,.2880659,.0967078,.7162162,.3303623,.1549741,27.03177
27030,2154,158,214,1329,1543,883,395,176,1030,445,199,147,50,23,118,.7468355,.6869159,.2336449,.1074766,.6644093,.2972159,.1324304,23.77707
27031,3675,299,422,2085,2507,1496,655,250,1765,718,262,269,63,12,214,.715719,.6374407,.1492891,.028436,.717506,.3141487,.1199041,6.284153
27032,76016,6250,13426,42426,55852,34473,19258,10164,46122,25454,11214,11649,6196,1050,4686,.74976,.8676448,.4614926,.0782065,.8125442,.4539198,.2395701,14.02935
27033,4428,233,367,2760,3127,1826,693,283,2061,764,296,235,71,13,184,.7896996,.640327,.1934605,.0354223,.6615942,.251087,.1025362,21.77704
27034,12660,851,1257,8005,9262,5976,2534,1098,7006,2846,1157,1030,312,59,615,.7226792,.8194113,.24821,.0469372,.7465334,.3165522,.1371643,16.37132
27035,655,46,60,384,444,276,119,68,327,147,71,51,28,3,38,.8260869,.85,.4666667,.05,.71875,.3098958,.1770833,22.16097
27036,5367,457,651,3078,3729,2031,779,242,2503,934,265,472,155,23,290,.6345733,.7250384,.2380952,.0353303,.659844,.2530864,.0786225,27.44677
27037,6731,480,696,3881,4577,2667,1233,599,3172,1344,628,505,111,29,390,.8125,.7255747,.1594828,.0416667,.687194,.3177016,.1543417,24.46852
27038,2520,157,256,1503,1759,1109,501,212,1299,551,233,190,50,21,115,.7324841,.7421875,.1953125,.0820313,.7378576,.3333333,.1410512,21.26971
27039,6958,449,771,4242,5013,2926,1178,621,3431,1270,625,505,92,4,340,.7572383,.6549935,.1193255,.0051881,.689769,.2776992,.1463932,16.78583
27040,1836,117,159,1153,1312,686,323,92,801,367,93,115,44,1,88,.7521368,.7232704,.2767296,.0062893,.5949696,.2801388,.0797918,30.72113
27041,22493,1671,1810,13749,15559,10242,4881,2473,11455,5205,2562,1213,324,89,1254,.7504488,.6701657,.1790055,.0491713,.7449269,.3550076,.1798676,29.85797
27042,12243,897,1773,6617,8390,4410,2080,790,5698,2467,900,1288,387,110,524,.5841694,.7264524,.2182741,.0620417,.6664652,.3143418,.1193895,26.4681
27043,10467,780,1199,5641,6840,3856,1775,671,4634,2040,728,778,265,57,434,.5564103,.648874,.2210175,.0475396,.6835667,.3146605,.1189505,37.37109
27044,9899,751,1230,4995,6225,3619,1425,639,4497,1607,701,878,182,62,473,.6298269,.7138211,.1479675,.0504065,.7245245,.2852853,.1279279,34.08019
27045,8675,565,733,5269,6002,3572,1425,702,4083,1515,749,511,90,47,448,.7929204,.6971351,.1227831,.0641201,.6779275,.2704498,.1332321,18.49159
27046,5414,410,610,3351,3961,2268,1157,430,2743,1354,484,475,197,54,303,.7390244,.7786885,.3229508,.0885246,.6768129,.3452701,.1283199,23.19209
27047,38092,2734,4310,22933,27243,15852,6465,3255,19266,7768,3508,3414,1303,253,2005,.7333577,.7921114,.3023202,.0587007,.691231,.2819082,.1419352,20.49432
27048,5598,397,463,3528,3991,2501,1101,435,2816,1175,446,315,74,11,326,.8211587,.6803456,.1598272,.0237581,.7089002,.3120748,.1232993,14.03223
27049,3216,184,268,2081,2349,1401,658,291,1616,727,302,215,69,11,143,.7771739,.8022388,.2574627,.0410448,.673234,.3161941,.1398366,27.73652
27050,6491,442,540,3978,4518,2680,1249,594,3051,1397,628,371,148,34,321,.7262443,.6870371,.2740741,.062963,.6737054,.3139769,.1493213,20.85856
27051,5559,402,605,3248,3853,2327,1061,458,2795,1214,477,468,153,19,328,.8159204,.7735537,.2528926,.031405,.7164409,.3266626,.1410099,13.1137
27052,981,55,86,607,693,429,170,67,494,185,74,65,15,7,37,.6727273,.755814,.1744186,.0813954,.7067545,.2800659,.1103789,24.97972
27053,10250,777,1073,5890,6963,4288,1808,761,5029,1992,818,741,184,57,560,.7207207,.6905872,.1714818,.0531221,.7280136,.3069609,.129202,19.99519
27054,2359,146,178,1485,1663,1041,405,214,1163,422,214,122,17,0,118,.8082192,.6853933,.0955056,0,.7010101,.2727273,.1441077,21.55477
27055,1476,109,138,858,996,516,223,72,634,271,73,118,48,1,66,.6055046,.8550724,.3478261,.0072464,.6013986,.2599068,.0839161,35.70537
27056,108035,8045,14674,61582,76256,47183,24456,12228,58949,28927,13129,11766,4471,901,5885,.7315103,.8018264,.3046886,.0614011,.7661816,.397129,.1985645,13.2699
27057,275,27,33,169,202,127,92,56,157,110,63,30,18,7,19,.7037037,.9090909,.5454546,.2121212,.7514793,.5443787,.3313609,0
28001,30656,2451,4519,18291,22810,13803,5901,2749,17601,7368,2902,3798,1467,153,1852,.7556099,.8404514,.3246293,.033857,.7546334,.3226177,.1502925,18.23159
28002,8675,632,804,5295,6099,3702,1239,404,4391,1417,442,689,178,38,471,.7452531,.8569652,.221393,.0472637,.6991501,.2339943,.0762984,40.20557
28003,513,37,50,326,376,250,73,27,297,96,29,47,23,2,25,.6756757,.94,.46,.04,.7668712,.2239264,.0828221,18.70287
28004,918,65,85,564,649,438,165,57,496,178,61,58,13,4,45,.6923077,.682353,.1529412,.0470588,.7765958,.2925532,.1010638,12.73938
28005,867,78,80,512,592,370,152,56,431,175,60,61,23,4,54,.6923077,.7625,.2875,.05,.7226563,.296875,.109375,36.20072
28006,7391,502,745,4472,5217,2949,895,410,3539,1043,442,590,148,32,361,.7191235,.7919463,.1986577,.042953,.6594365,.2001342,.0916816,37.41444
28007,13696,877,1940,7679,9619,5845,2344,967,7451,2786,1028,1606,442,61,475,.5416192,.827835,.227835,.0314433,.7611668,.3052481,.1259279,19.82684
28008,3331,194,353,2193,2546,1311,484,189,1585,581,204,274,97,15,152,.7835051,.776204,.2747875,.0424929,.5978112,.2207022,.0861833,48.59198
28009,4377,305,406,2716,3122,1807,622,257,2116,710,287,309,88,30,210,.6885246,.7610837,.2167488,.0738916,.6653166,.2290132,.0946244,29.51671
28010,34797,3605,7373,18185,25558,13981,7081,3478,20573,10656,3886,6592,3575,408,3068,.8510402,.8940729,.4848773,.055337,.7688205,.3893869,.1912565,27.14013
28011,8813,562,765,5743,6508,3798,1341,543,4367,1501,587,569,160,44,423,.752669,.7437909,.2091503,.0575163,.6613268,.2335017,.0945499,30.08216
28012,9330,641,870,5820,6690,3566,1095,445,4285,1336,495,719,241,50,506,.7893916,.8264368,.2770115,.0574713,.6127148,.1881443,.0764605,36.37543
28013,20297,1430,2131,11939,14070,8685,2890,1229,10397,3362,1311,1712,472,82,1026,.7174825,.8033787,.2214923,.0384796,.7274479,.2420638,.1029399,24.84615
28014,11375,837,1137,6508,7645,4002,1422,505,4936,1777,611,934,355,106,693,.827957,.82146,.3122252,.0932278,.6149355,.2185003,.0775968,40.93935
28015,4758,283,427,2868,3295,2070,892,369,2416,1004,398,346,112,29,219,.7738516,.8103045,.2622951,.0679157,.7217573,.3110181,.1286611,25.85895
28016,6758,441,735,4103,4838,3028,1398,543,3619,1609,586,591,211,43,316,.7165533,.8040816,.2870748,.0585034,.7379966,.3407263,.1323422,23.85693
28017,10057,749,1163,6107,7270,4479,1971,790,5408,2297,824,929,326,34,550,.7343124,.7987962,.2803096,.0292347,.7334207,.3227444,.1293598,14.83685
28018,8106,565,854,4931,5785,3392,1271,524,4035,1500,590,643,229,66,415,.7345133,.7529274,.2681499,.0772834,.6878929,.257757,.1062665,31.79348
28019,9890,704,983,6051,7034,3532,1080,459,4330,1318,487,798,238,28,534,.7585227,.8118006,.242116,.0284842,.5837052,.1784829,.0758552,32.9649
28020,11664,880,1165,6954,8119,4264,1326,547,5230,1632,618,966,306,71,709,.8056818,.8291845,.262661,.0609442,.6131723,.1906816,.0786598,32.97539
28021,13877,823,1194,8861,10055,6168,2352,867,7111,2642,903,943,290,36,633,.7691373,.7897822,.2428811,.0301508,.696084,.2654328,.0978445,33.4399
28022,16573,1194,2032,9112,11144,6176,1990,831,7680,2361,908,1504,371,77,754,.6314908,.7401575,.1825787,.0378937,.6777875,.2183933,.0911984,19.64459
28023,9609,1109,1968,5244,7212,4004,1905,947,5775,2824,1063,1771,919,116,866,.7808837,.8998984,.4669715,.0589431,.7635393,.3632723,.1805873,25.27995
28024,22304,1433,2371,13194,15565,9311,3747,1640,11137,4316,1741,1826,569,101,975,.6803908,.7701392,.2399831,.0425981,.7056996,.2839927,.1242989,25.21569
28025,2462,192,198,1598,1796,1134,531,210,1266,558,216,132,27,6,138,.71875,.6666667,.1363636,.030303,.709637,.3322904,.1314143,16.91358
28026,7137,504,713,4307,5020,2842,1002,406,3382,1165,444,540,163,38,413,.8194444,.7573633,.2286115,.0532959,.659856,.2326445,.0942651,32.11459
28027,35847,2662,4464,21394,25858,14654,5236,2337,18273,6364,2521,3619,1128,184,1862,.6994741,.8107079,.2526882,.0412186,.6849584,.2447415,.1092362,19.33003
28028,397038,30148,54505,227140,281645,174368,87937,45875,218486,108064,50794,44118,20127,4919,22331,.7407125,.8094303,.3692689,.0902486,.7676675,.3871489,.201968,12.68362
28029,2861,149,265,1900,2165,1152,477,192,1373,539,195,221,62,3,116,.7785235,.8339623,.2339623,.0113208,.6063158,.2510526,.1010526,32.51109
28030,7920,489,666,5109,5775,3529,1233,507,4047,1433,559,518,200,52,400,.8179959,.7777778,.3003003,.0780781,.6907418,.2413388,.0992366,31.58062
28031,4377,252,353,2959,3312,1802,693,286,2066,787,313,264,94,27,202,.8015873,.7478753,.266289,.0764873,.6089895,.2342007,.0966543,37.35546
28032,3647,289,475,2172,2647,1533,615,276,1961,785,286,428,170,10,216,.7474049,.9010527,.3578947,.0210526,.7058011,.2831492,.1270718,29.75975
28033,6486,337,553,4353,4906,2975,1152,482,3368,1292,532,393,140,50,265,.7863501,.7106691,.2531646,.0904159,.6834367,.2646451,.1107282,30.46835
28034,24456,1630,2666,15628,18294,9659,3354,1556,11550,4009,1697,1891,655,141,1116,.6846626,.7093023,.2456864,.0528882,.6180573,.2146148,.0995649,27.38561
28035,2802,155,227,1914,2141,1339,575,200,1507,628,206,168,53,6,120,.7741935,.7400881,.2334802,.0264317,.699582,.300418,.1044932,25.67372
28036,2363,160,174,1534,1708,942,352,153,1092,394,160,150,42,7,123,.76875,.862069,.2413793,.0402299,.6140808,.2294655,.0997392,34.14275
28037,2140,153,204,1344,1548,912,315,116,1079,360,128,167,45,12,117,.7647059,.8186275,.2205882,.0588235,.6785714,.234375,.0863095,26.31791
28038,877,66,91,518,609,414,146,57,477,166,64,63,20,7,43,.6515151,.6923077,.2197802,.0769231,.7992278,.2818533,.1100386,21.71815
28039,3462,251,293,2070,2363,1463,447,180,1722,516,202,259,69,22,198,.7888446,.8839591,.2354949,.0750853,.7067633,.215942,.0869565,46.20491
28040,47690,3236,5438,27713,33151,20728,8494,3576,25120,9850,3929,4392,1356,353,2187,.6758344,.8076499,.2493564,.0649136,.7479522,.3064988,.1290369,22.15816
28041,9301,606,927,5549,6476,4121,1729,736,4913,2025,796,792,296,60,445,.7343234,.8543689,.3193096,.0647249,.7426564,.3115877,.1326365,23.65074
28042,4292,260,337,2856,3193,2093,694,309,2354,769,321,261,75,12,210,.8076923,.7744807,.2225519,.0356083,.7328432,.2429972,.1081933,29.51375
28043,1356,89,124,841,965,654,233,66,757,277,71,103,44,5,61,.6853933,.8306451,.3548387,.0403226,.7776456,.2770511,.078478,29.39914
28044,4079,261,393,2550,2943,1770,684,231,2084,772,243,314,88,12,194,.743295,.7989822,.2239186,.0305344,.6941177,.2682353,.0905882,23.72569
28045,13552,937,1407,7900,9307,5368,1907,691,6494,2174,761,1126,267,70,684,.7299893,.8002843,.1897655,.0497512,.6794937,.2413924,.0874684,40.52463
28046,990,79,91,638,729,450,184,75,511,204,78,61,20,3,68,.8607595,.6703297,.2197802,.032967,.7053292,.2884012,.1175549,20.21997
28047,6773,478,622,4082,4704,2802,974,405,3291,1041,424,489,67,19,328,.6861925,.7861736,.107717,.0305466,.6864282,.2386085,.0992161,37.888
28048,9817,716,1056,6403,7459,4107,1641,554,4960,1966,575,853,325,21,535,.7472067,.8077651,.3077652,.0198864,.6414181,.2562861,.0865219,28.48521
28049,5285,323,468,3456,3924,2119,646,308,2511,769,319,392,123,11,255,.7894737,.8376068,.2628205,.0235043,.6131366,.1869213,.0891204,42.40566
28050,7053,468,715,4394,5109,3219,1407,603,3789,1669,659,570,262,56,353,.7542735,.7972028,.3664336,.0783217,.7325899,.3202094,.1372326,21.49235
28051,9364,634,1001,5645,6646,4117,1613,644,4878,1826,677,761,213,33,462,.7287066,.7602398,.2127872,.032967,.729318,.2857396,.1140833,21.89371
28052,1301,92,136,786,922,533,189,64,647,215,78,114,26,14,70,.7608696,.8382353,.1911765,.1029412,.678117,.240458,.0814249,36.83536
28053,4882,367,550,2919,3469,2007,847,296,2408,979,312,401,132,16,263,.7166213,.7290909,.24,.0290909,.6875643,.2901679,.1014046,11.67537
28054,11457,775,1048,7094,8142,4353,1528,556,5185,1765,604,832,237,48,625,.8064516,.7938932,.226145,.0458015,.6136171,.2153933,.0783761,37.23697
28055,192884,16917,38943,107020,145963,87202,48129,25585,121715,68172,29315,34513,20043,3730,13508,.7984867,.886244,.5146753,.095781,.8148196,.4497197,.2390675,13.667
28056,36455,2580,4472,20841,25313,15753,6538,2516,19280,7755,2746,3527,1217,230,1621,.6282946,.7886851,.2721377,.0514311,.7558658,.3137085,.1207236,20.81586
28057,983,66,94,581,675,432,164,61,494,191,69,62,27,8,60,.9090909,.6595744,.287234,.0851064,.7435456,.282272,.1049914,23.00885
28058,859,51,81,528,609,378,138,60,446,168,65,68,30,5,41,.8039216,.8395061,.3703704,.0617284,.7159091,.2613636,.1136364,30.86844
28059,593,39,72,370,442,229,95,41,296,123,54,67,28,13,26,.6666667,.9305556,.3888889,.1805556,.6189189,.2567568,.1108108,18.65966
28060,31382,2445,4653,18098,22751,12472,5629,2147,16466,7070,2303,3994,1441,156,1810,.7402863,.858371,.3096927,.0335268,.6891369,.3110288,.1186319,23.45457
28061,8945,684,894,5313,6207,3661,1303,512,4328,1480,539,667,177,27,490,.7163743,.746085,.1979866,.0302013,.6890646,.2452475,.0963674,34.3966
28062,6085,430,640,3710,4350,2327,932,322,2775,1077,341,448,145,19,263,.6116279,.7,.2265625,.0296875,.6272237,.2512129,.0867925,25.71757
28063,4740,320,454,2899,3353,1866,651,234,2216,749,261,350,98,27,264,.825,.7709251,.215859,.0594714,.6436703,.2245602,.0807175,37.35027
28064,8367,603,1095,5178,6273,3508,1476,728,4499,1935,780,991,459,52,440,.7296849,.9050229,.4191781,.0474886,.6774817,.2850522,.1405948,35.66922
28065,6726,458,613,4312,4925,2931,887,402,3475,1098,427,544,211,25,333,.7270743,.8874388,.3442088,.040783,.679731,.205705,.0932282,28.50566
28066,15183,1020,1394,9675,11069,6370,1891,731,7464,2277,812,1094,386,81,743,.7284313,.7847919,.276901,.0581062,.6583979,.1954522,.0755556,27.04767
28067,3937,235,298,2721,3019,1780,519,201,2015,583,206,235,64,5,202,.8595745,.7885906,.2147651,.0167785,.6541713,.1907387,.0738699,43.25971
28068,3637,212,323,2272,2595,1583,745,316,1823,839,345,240,94,29,165,.7783019,.7430341,.2910217,.0897833,.696743,.3279049,.1390845,23.07866
28069,9769,637,968,6170,7138,4564,2019,839,5280,2266,890,716,247,51,474,.744113,.7396694,.2551653,.0526859,.7397082,.3272285,.1359805,20.76412
28070,8481,593,912,5096,6008,3274,1006,403,4017,1141,429,743,135,26,448,.7554806,.814693,.1480263,.0285088,.6424647,.1974097,.0790816,40.36982
28071,28852,2262,3448,16358,19806,11897,4787,2175,14749,5727,2362,2852,940,187,1702,.7524315,.8271462,.2726218,.0542343,.7272894,.2926397,.1329625,23.66622
28072,6320,410,455,4013,4468,2890,951,376,3259,1085,420,369,134,44,325,.7926829,.810989,.2945055,.0967033,.7201595,.2369798,.0936955,29.2666
28073,12615,1020,1582,7517,9099,5668,2360,926,6929,2741,969,1261,381,43,737,.722549,.7970923,.2408344,.0271808,.7540242,.313955,.1231874,19.84229
28074,11315,761,1045,7458,8503,4722,1624,816,5535,1794,847,813,170,31,552,.7253613,.7779905,.1626794,.0296651,.6331456,.2177528,.1094127,30.20758
28075,2383,138,212,1455,1667,1000,412,155,1182,455,167,182,43,12,114,.8260869,.8584906,.2028302,.0566038,.6872852,.2831615,.1065292,30.94874
28076,13131,1030,1757,8097,9854,5403,1845,858,6923,2449,879,1520,604,21,890,.8640777,.865111,.3437678,.0119522,.6672842,.2278622,.1059652,28.73421
28077,86015,7096,11985,43499,55484,37337,18465,9300,47265,21672,9859,9928,3207,559,5035,.7095547,.8283688,.2675845,.0466416,.8583416,.4244925,.213798,13.51081
28078,18716,1416,1835,11338,13173,7650,2589,1036,9064,2999,1136,1414,410,100,1096,.7740113,.7705722,.2234332,.0544959,.6747222,.2283472,.0913741,28.30092
28079,38344,2716,4373,22389,26762,14856,7007,2793,17989,8186,3011,3133,1179,218,1991,.7330633,.7164418,.269609,.0498514,.6635401,.3129662,.1247488,23.24814
28080,15789,1533,2841,8717,11558,5961,2343,1076,8563,3548,1172,2602,1205,96,1355,.8838878,.9158747,.4241464,.0337909,.6838362,.2687851,.123437,34.27601
28081,7544,513,731,4654,5385,3111,1330,559,3643,1510,586,532,180,27,347,.6764132,.7277701,.246238,.0369357,.6684573,.2857757,.1201117,23.14986
28082,4226,262,329,2639,2968,1606,461,170,1860,536,184,254,75,14,223,.851145,.7720365,.2279635,.0425532,.6085638,.1746874,.0644183,38.94257
28083,1845,143,189,1146,1335,881,347,125,1045,389,129,164,42,4,86,.6013986,.8677249,.2222222,.021164,.7687609,.3027923,.109075,20.42809
28084,6549,409,705,3599,4304,2390,991,345,3008,1253,402,618,262,57,334,.8166259,.8765957,.3716312,.0808511,.6640733,.2753543,.09586,38.11206
28085,7582,455,647,4998,5645,3112,1081,460,3625,1226,491,513,145,31,339,.745055,.7928903,.2241113,.0479134,.6226491,.2162865,.0920368,35.4603
28086,973,50,87,580,667,444,191,64,509,208,69,65,17,5,43,.86,.7471265,.1954023,.0574713,.7655172,.3293104,.1103448,28.65221
28087,7186,562,799,3974,4773,2366,862,305,2925,1021,317,559,159,12,344,.6120996,.6996245,.1989987,.0150188,.5953699,.2169099,.0767489,42.0442
28088,5633,357,504,3605,4109,2411,860,367,2809,959,383,398,99,16,254,.7114846,.7896826,.1964286,.031746,.6687933,.2385576,.101803,36.18683
28089,15508,1356,1890,8981,10871,6488,2565,1240,8105,3119,1304,1617,554,64,1043,.769174,.8555555,.2931217,.0338624,.722414,.2856029,.1380693,23.00863
28090,9858,1174,2316,5222,7538,3773,1860,952,5898,3130,1047,2125,1270,95,1036,.8824531,.9175302,.5483592,.041019,.7225201,.3561854,.1823056,28.73476
28091,4858,317,343,3255,3598,2206,822,298,2473,887,309,267,65,11,256,.807571,.7784256,.1895044,.03207,.6777266,.2525346,.0915515,32.50794
28092,1060,68,128,594,722,415,179,64,513,199,69,98,20,5,63,.9264706,.765625,.15625,.0390625,.6986532,.3013468,.1077441,28.70066
28093,14798,1116,1794,8847,10641,6530,2710,1204,8092,3307,1269,1562,597,65,937,.8396057,.87068,.3327759,.0362319,.7381033,.3063185,.1360913,24.93284
29001,13917,943,1691,8246,9937,5906,2402,932,7357,2851,957,1451,449,25,616,.6532344,.8580722,.2655233,.0147842,.716226,.2912928,.1130245,17.65868
29002,463087,32841,62158,272445,334603,201721,89294,34330,249153,102991,36181,47432,13697,1851,19216,.5851222,.7630876,.2203578,.0297789,.74041,.3277506,.1260071,11.50625
29003,19421,1266,1791,12640,14431,10756,5785,2172,12150,6257,2264,1394,472,92,878,.6935229,.7783361,.2635399,.0513679,.8509493,.4576741,.1718354,14.63557
29004,17269,1249,1872,10003,11875,6940,3028,1271,8268,3442,1342,1328,414,71,816,.6533226,.7094017,.2211538,.0379274,.6937919,.3027092,.1270619,14.99315
29005,777,37,82,506,588,342,127,66,407,139,69,65,12,3,25,.6756757,.7926829,.1463415,.0365854,.6758893,.2509882,.1304348,14.28571
29006,1198,98,125,691,816,428,158,71,505,199,76,77,41,5,64,.6530612,.616,.328,.04,.6193922,.2286541,.1027496,29.32432
29007,9434,680,1046,5483,6529,3805,1563,683,4459,1699,683,654,136,0,474,.6970588,.625239,.1300191,0,.6939632,.2850629,.1245668,15.95875
29008,4076,205,681,2141,2822,1425,525,210,1974,647,236,549,122,26,89,.4341463,.8061674,.1791483,.0381791,.6655768,.2452125,.098085,21.49274
29009,3732,331,373,2022,2395,1388,614,269,1633,685,287,245,71,18,190,.5740181,.6568365,.1903485,.0482574,.6864491,.3036597,.1330366,34.41955
29010,13594,814,1277,8372,9649,5892,2101,713,6795,2296,749,903,195,36,439,.5393121,.7071261,.1527016,.0281911,.7037745,.2509556,.0851648,18.67966
29011,6217,375,567,3775,4342,2357,819,276,2772,920,294,415,101,18,244,.6506667,.7319224,.1781305,.031746,.6243709,.2169536,.0731126,14.68612
29012,9048,618,996,5473,6469,3805,1434,519,4480,1596,549,675,162,30,394,.6375405,.6777108,.1626506,.0301205,.6952311,.2620135,.0948292,19.50502
29013,32022,2360,3720,20083,23803,15772,7689,3178,18240,8419,3276,2468,730,98,1512,.640678,.6634409,.1962366,.0263441,.7853408,.3828611,.1582433,11.56311
29014,3408,217,436,2043,2479,1324,440,128,1543,472,130,219,32,2,104,.4792627,.5022936,.0733945,.0045872,.6480666,.2153696,.062653,15.8867
29015,1503,92,183,954,1137,780,394,149,926,439,162,146,45,13,64,.6956522,.7978142,.2459016,.0710383,.8176101,.4129979,.1561845,10.72125
29016,193623,13649,27644,119740,147384,95856,50403,23564,117573,59158,25291,21717,8755,1727,8492,.6221702,.7855954,.3167053,.0624729,.8005345,.420937,.196793,11.1145
29017,8167,576,669,4984,5653,3524,1458,716,4013,1600,733,489,142,17,416,.7222222,.7309417,.2122571,.0254111,.7070626,.2925361,.1436597,18.44057
30001,42884,2947,4596,26456,31052,18574,8873,4297,21935,9982,4539,3361,1109,242,1838,.6236851,.7312881,.2412968,.0526545,.7020714,.3353871,.1624206,15.03173
30002,27931,1602,2464,18384,20848,14245,7534,3806,16158,8258,3975,1913,724,169,1239,.7734082,.7763799,.2938312,.0685877,.7748586,.4098129,.2070279,25.04649
30003,62116,5199,8615,36716,45331,26397,12338,6622,33364,15266,7030,6967,2928,408,3981,.7657242,.8087057,.3398723,.0473593,.7189509,.3360388,.1803573,13.82255
30004,35147,2423,3688,21580,25268,12678,4320,1776,15446,5018,1893,2768,698,117,1738,.7172926,.7505423,.1892625,.0317245,.5874884,.2001854,.0822984,15.47264
30005,65806,6041,11733,37742,49475,27582,14208,8249,37922,19650,9202,10340,5442,953,5002,.8280086,.8812751,.46382,.0812239,.7308039,.3764506,.2185629,20.02801
30006,276608,20857,33972,161546,195518,114861,57261,29875,141027,67602,32000,26166,10341,2125,14685,.7040802,.7702225,.3043977,.0625515,.7110111,.3544563,.1849318,12.82508
30007,98302,7388,12140,59196,71336,43786,22208,11724,53618,25870,12432,9832,3662,708,5225,.7072279,.8098847,.3016475,.0583196,.7396784,.3751605,.1980539,14.54545
30008,190345,13134,22129,112142,134271,86707,42619,21470,104396,48964,22859,17689,6345,1389,9105,.6932389,.7993583,.2867278,.0627683,.7731894,.3800449,.1914537,14.74411
30009,85408,8705,16783,46240,63023,32364,15143,8120,46962,22668,8949,14598,7525,829,6739,.7741528,.8698087,.4483704,.0493952,.6999135,.327487,.1756055,13.39541
30010,36063,2484,3863,21951,25814,14374,5648,2745,17073,6357,2898,2699,709,153,1668,.6714976,.6986798,.1835361,.0396065,.6548221,.2573003,.1250512,18.99147
31001,194119,13395,22479,120411,142890,73903,30315,15033,90840,37111,16388,16937,6796,1355,9497,.7089959,.7534588,.3023266,.0602785,.6137562,.2517627,.1248474,22.77329
31002,845385,57754,94058,552098,646156,406931,212039,131648,487924,252103,142649,80993,40064,11001,46505,.8052256,.8610963,.4259499,.1169598,.737063,.3840604,.2384504,5.378932
31003,362542,31491,48516,206050,254566,153179,70480,37940,189468,82101,40774,36289,11621,2834,20062,.6370709,.7479801,.2395292,.0584137,.743407,.3420529,.1841301,12.25019
31004,471650,34629,56409,277983,334392,182108,79902,45102,224271,95251,48972,42163,15349,3870,25540,.7375321,.7474517,.272102,.0686061,.6551048,.2874348,.1622473,12.0772
31005,82266,5344,9001,53926,62927,33685,13533,7003,40551,15715,7648,6866,2182,645,3264,.6107785,.7628042,.2424175,.0716587,.6246523,.250955,.1298631,22.03668
31006,132866,9850,14779,77571,92350,41340,14650,6749,50885,17353,7239,9545,2703,490,6677,.677868,.6458488,.1828946,.0331552,.5329311,.1888592,.0870042,20.89878
31007,851116,60948,100202,510889,611091,320897,155467,91773,394670,188905,99826,73773,33438,8053,43384,.7118199,.7362428,.3337059,.0803677,.6281149,.3043068,.1796339,13.79936
31008,199917,15564,26120,113641,139761,75177,29071,14849,95794,37005,16226,20617,7934,1377,11393,.7320098,.7893185,.3037519,.0527182,.6615306,.2558144,.1306659,13.58724
31009,556972,39048,69534,343115,412649,176864,68892,38324,226161,88846,43034,49297,19954,4710,27443,.7028017,.7089625,.2869675,.0677366,.5154657,.200784,.1116943,12.91426
31010,87361,6438,8674,52929,61603,40277,20675,12782,46629,22782,13229,6352,2107,447,4654,.7228953,.7323034,.2429098,.0515333,.7609628,.3906176,.2414933,13.73369
31011,307863,24078,42680,186680,229360,126495,65070,40636,161883,82908,44172,35388,17838,3536,18666,.7752305,.8291472,.4179475,.0828491,.6776034,.3485644,.2176773,11.96779
31012,595893,48608,86701,354978,441679,248606,110256,64428,321912,146148,72084,73306,35892,7656,37877,.7792339,.8455035,.4139745,.0883035,.700342,.3105995,.1814986,7.67433
31013,503173,36746,53475,305233,358708,225920,114487,65862,268403,130990,69843,42483,16503,3981,27852,.75796,.794446,.3086115,.074446,.7401559,.3750807,.2157761,13.79294
31014,407630,30299,44651,246933,291584,198039,111900,70629,235375,130003,75272,37336,18103,4643,24706,.8154064,.8361739,.4054332,.1039842,.8019949,.4531594,.286025,6.575052
31015,346038,20511,30740,224199,254939,146189,57486,27870,169812,65645,29668,23623,8159,1798,14835,.7232704,.7684776,.2654197,.0584906,.6520502,.2564061,.1243092,17.36638
31016,447585,32101,54454,270255,324709,157545,66725,37173,198624,83015,41050,41079,16290,3877,21748,.6774867,.7543799,.2991516,.0711977,.5829495,.2468964,.1375479,11.62632
31017,64676,4773,7053,38476,45529,24031,8195,3447,29207,9659,3681,5176,1464,234,3395,.7112927,.7338721,.2075713,.0331774,.6245711,.2129899,.0895883,17.4154
31018,203129,14985,22285,126214,148499,97240,52842,33569,115759,61275,35880,18519,8433,2311,11741,.7835168,.8310074,.378416,.103702,.7704375,.4186699,.2659689,7.35635
31019,116119,7445,10475,68115,78590,51427,23401,12874,59707,26046,13499,8280,2645,625,5593,.7512425,.7904534,.252506,.0596659,.7550026,.3435513,.1890039,15.08345
31020,504094,34658,56712,323219,379931,221842,102674,61881,267980,124003,67235,46138,21329,5354,26394,.7615558,.8135492,.3760932,.0944068,.686352,.3176608,.1914522,7.523149
31021,84429,5875,9279,51332,60611,34203,12414,6468,41524,14669,7009,7321,2255,541,4281,.7286808,.7889859,.2430219,.0583037,.6663095,.2418375,.1260033,15.67636
32001,419700,34146,61400,236681,298081,181127,101179,53960,229532,120239,57596,48405,19060,3636,22828,.668541,.7883551,.3104235,.0592182,.765279,.427491,.2279862,18.96403
32002,2720,198,262,1603,1865,987,466,216,1160,487,226,173,21,10,134,.6767676,.6603053,.0801527,.0381679,.6157205,.2907049,.1347473,37.70891
32003,51103,4093,5980,29590,35570,18802,9147,3980,22717,10387,4120,3915,1240,140,2484,.6068898,.6546823,.2073579,.0234114,.6354173,.3091247,.1345049,25.30099
32004,13667,1157,1497,7787,9284,4999,2192,1016,6089,2418,1101,1090,226,85,712,.6153846,.7281229,.1509686,.0567802,.6419674,.2814948,.1304739,36.53186
32005,42019,3335,6344,21925,28269,15417,6513,2523,20369,7638,2697,4952,1125,174,1833,.5496252,.7805801,.1773329,.0274275,.7031699,.2970582,.1150741,28.47754
32006,2454,174,193,1630,1823,913,331,152,1041,349,154,128,18,2,113,.6494253,.6632124,.0932643,.0103627,.5601227,.2030675,.0932515,38.64091
32007,96340,9371,17509,47677,65186,31032,16741,9195,45343,23986,10020,14311,7245,825,7141,.7620318,.8173511,.4137872,.0471186,.6508799,.3511337,.1928603,31.96353
32008,47855,3335,5488,27135,32623,17028,6667,2977,20775,7553,3074,3747,886,97,1945,.5832084,.6827624,.1614431,.0176749,.627529,.2456974,.1097107,23.80803
32009,26204,2011,2990,14389,17379,9101,4013,1813,11383,4711,1945,2282,698,132,1474,.7329687,.7632107,.2334448,.0441472,.6324971,.2788936,.125999,35.15882
32010,4496,411,533,2412,2945,1181,394,176,1532,466,185,351,72,9,220,.5352798,.6585366,.1350844,.0168856,.4896352,.1633499,.0729685,52.86516
32011,1090,72,84,705,789,419,135,59,479,154,62,60,19,3,47,.6527778,.7142857,.2261905,.0357143,.5943263,.1914894,.0836879,44.51728
32012,6049,435,729,3115,3844,1867,664,285,2375,805,299,508,141,14,255,.5862069,.696845,.1934156,.0192044,.599358,.2131621,.0914928,31.51622
32013,55993,4162,7096,29723,36819,17824,7690,2959,22370,9170,3182,4546,1480,223,2508,.6025949,.6406426,.2085682,.0314262,.5996703,.2587222,.0995525,15.99675
32014,10997,714,1005,6847,7852,4777,2488,1072,5468,2685,1081,691,197,9,464,.64986,.6875622,.1960199,.0089552,.6976778,.3633708,.1565649,36.68128
32015,17599,1185,1137,10805,11942,10175,7539,5168,11108,7907,5249,933,368,81,1004,.8472574,.8205805,.3236588,.0712401,.9416937,.6977325,.4782971,2.163443
32016,15585,1097,1516,9318,10834,5307,1994,999,6162,2158,1007,855,164,8,645,.5879672,.5639842,.1081794,.005277,.5695428,.2139944,.1072119,38.85709
32017,56449,5189,8001,24935,32936,12758,5583,2661,17280,6701,2884,4522,1118,223,2671,.5147427,.5651793,.1397325,.0278715,.5116503,.2239022,.1067175,48.58546
32018,4205,377,449,2349,2798,1036,377,233,1336,440,237,300,63,4,241,.6392573,.6681514,.1403118,.0089087,.4410387,.1604938,.0991911,80.23009
32019,44665,3800,7165,22881,30046,17645,7990,3367,23514,9189,3516,5869,1199,149,2336,.6147369,.8191207,.1673412,.0207955,.7711638,.349198,.1471527,20.90477
32020,10577,790,905,6362,7267,3799,1545,785,4375,1653,812,576,108,27,551,.6974683,.6364641,.119337,.0298343,.5971392,.2428482,.1233889,35.01793
32021,29282,2532,3597,14928,18525,8417,3082,1513,11152,3726,1567,2735,644,54,1262,.4984202,.7603558,.1790381,.0150125,.5638398,.2064577,.1013532,61.01934
32022,15695,1653,3165,8312,11477,5370,2849,1348,8074,4266,1511,2704,1417,163,1237,.7483364,.8543444,.4477093,.0515008,.6460539,.3427575,.1621752,27.72353
32023,34799,2777,3855,19146,23001,12835,6043,2849,15567,6790,2909,2732,747,60,1792,.6453007,.70869,.1937743,.0155642,.670375,.3156273,.1488039,71.36343
32024,81433,6895,11457,39412,50869,25670,10984,4493,33400,12833,4803,7730,1849,310,3707,.537636,.6746967,.1613861,.0270577,.6513245,.2786968,.1140008,29.71825
32025,22751,2171,3445,12213,15658,6823,3503,1869,9230,4412,1964,2407,909,95,1500,.6909258,.6986938,.2638607,.0275762,.558667,.2868255,.1530337,59.7028
32026,75360,5821,8682,43801,52483,33208,19897,11916,39784,22221,12449,6576,2324,533,3775,.648514,.7574292,.2676803,.0613914,.7581562,.454259,.2720486,32.35197
32027,8454,414,517,6016,6533,3268,1201,417,3630,1291,435,362,90,18,257,.620773,.7001934,.1740812,.0348162,.5432181,.1996343,.0693152,40.94174
32028,12566,1110,1921,6354,8275,4042,1892,997,5415,2470,1107,1373,578,110,613,.5522522,.7147319,.300885,.0572618,.6361347,.2977652,.156909,48.74452
32029,19456,1512,2038,10758,12796,6751,3270,1446,8288,3635,1526,1537,365,80,799,.5284392,.7541708,.1790972,.0392542,.627533,.3039598,.1344116,72.77721
32030,7491,498,767,4312,5079,2517,830,409,3039,925,426,522,95,17,270,.5421687,.6805736,.1238592,.0221643,.5837198,.1924861,.0948516,47.96822
32031,4725,395,421,2890,3311,1798,603,308,2103,668,334,305,65,26,258,.6531646,.7244655,.1543943,.0617577,.6221454,.2086505,.1065744,32.93464
32032,61115,4872,7861,31136,38997,20014,7702,3184,25570,8902,3333,5556,1200,149,2152,.4417077,.7067803,.1526523,.0189543,.6427929,.2473664,.1022611,30.9514
33001,285909,22979,42875,173637,216512,124484,65450,38743,161425,86321,43392,36941,20871,4649,18594,.8091736,.8615977,.4867872,.1084315,.7169209,.3769358,.2231264,14.16631
33002,51742,6514,10198,26867,37065,18272,8021,3660,27420,12371,4002,9148,4350,342,5536,.8498619,.8970386,.4265542,.033536,.6800908,.2985447,.1362266,24.40256
33003,1168972,88398,144963,682675,827638,346913,135036,61785,436194,177303,69430,89281,42267,7645,61198,.6923007,.6158882,.291571,.0527376,.5081671,.1978042,.0905043,16.63942
33004,213648,17656,30104,127747,157851,88622,38951,19907,113860,51466,21927,25238,12515,2020,13624,.7716357,.8383604,.4157255,.0671007,.6937306,.3049074,.1558314,11.16212
33005,85697,6679,11114,48963,60077,31706,11971,5231,40334,15340,5641,8628,3369,410,4940,.7396317,.7763181,.3031312,.0368904,.6475502,.2444907,.1068358,18.961
33006,79894,6019,9458,47072,56530,29305,11806,5136,36392,14570,5511,7087,2764,375,4292,.7130753,.7493128,.2922394,.039649,.6225569,.2508073,.1091094,18.16378
33007,146925,11547,19062,87429,106491,57538,23082,10348,72973,29573,11199,15435,6491,851,8724,.7555209,.8097262,.3405204,.0446438,.6581112,.2640085,.1183589,15.75469
33008,97656,7891,12302,57694,69996,40120,15904,7689,48765,18861,8120,8645,2957,431,5497,.6966164,.7027313,.2403674,.035035,.6953929,.2756613,.1332721,15.72368
33009,49344,3772,5186,28721,33907,18520,7264,3433,22429,8373,3672,3909,1109,239,2682,.7110286,.7537601,.213845,.0460856,.6448243,.252916,.1195293,18.89773
33010,80750,8092,15757,42065,57822,26812,12593,5930,39619,18121,6448,12807,5528,518,5950,.7352941,.8127816,.3508282,.0328743,.6373945,.29937,.1409723,23.45935
33011,59487,3984,5636,37572,43208,23657,10670,5167,27762,12233,5464,4105,1563,297,2900,.7279117,.7283534,.2773243,.0526969,.6296444,.2839881,.1375226,18.02617
33012,48820,5277,9336,25930,35266,17169,7712,3907,25199,12035,4303,8030,4323,396,4322,.8190259,.8601114,.4630463,.0424165,.6621288,.2974161,.1506749,16.9684
33013,46824,4468,6080,27980,34060,18021,7469,3290,22886,9058,3504,4865,1589,214,3731,.8350492,.8001645,.2613487,.0351974,.6440672,.2669407,.117584,23.2275
33014,245055,19314,30519,146169,176688,103147,52259,27621,127314,64083,29660,24167,11824,2039,14612,.7565497,.7918674,.3874308,.0668108,.7056695,.3575245,.1889662,12.31299
33015,1015472,76995,131969,613302,745271,400798,183913,92701,508990,234985,102997,108192,51072,10296,58304,.757244,.8198289,.387,.0780183,.6535084,.2998735,.1511507,12.45706
33016,36176,2641,3629,22045,25674,14360,6413,3112,16954,7305,3321,2594,892,209,1986,.7519879,.7147974,.2457977,.0575916,.6513949,.290905,.1411658,25.79885
33017,44929,4157,6004,25258,31262,15097,6291,2925,19670,7747,3088,4573,1456,163,3092,.7438056,.7616589,.242505,.0271486,.5977116,.2490696,.1158049,30.50274
33018,55153,3900,5675,33578,39253,19988,7434,3127,24168,8781,3364,4180,1347,237,2725,.698718,.7365639,.2373568,.0417621,.5952707,.221395,.0931265,18.05222
33019,59400,4565,6829,34633,41462,23973,9302,4085,29238,10980,4345,5265,1678,260,3424,.7500548,.7709767,.2457168,.0380729,.6922011,.2685878,.1179511,13.76668
33020,40861,3100,4304,25603,29907,16062,5648,2511,19082,6656,2664,3020,1008,153,2053,.6622581,.7016729,.2342007,.0355483,.6273484,.2205991,.0980744,19.3742
33021,5034,353,428,3261,3689,2195,909,364,2512,1004,381,317,95,17,268,.7592068,.7406542,.2219626,.0397196,.6731064,.2787488,.1116222,23.13222
33022,66714,5144,7499,40006,47505,25141,9795,4166,30734,11899,4446,5593,2104,280,3980,.7737169,.7458328,.2805707,.0373383,.6284307,.2448383,.1041344,16.35439
33023,88151,6768,10146,50975,61121,32622,12488,5275,39911,14309,5595,7289,1821,320,4712,.6962175,.7184112,.1794796,.0315395,.6399608,.2449828,.1034821,20.27407
33024,2230936,153777,266284,1333366,1599650,732615,302920,154408,912189,390138,173911,179574,87218,19503,109085,.7093714,.6743702,.3275375,.0732414,.5494478,.2271844,.1158032,17.18403
33025,25035,1984,2885,13775,16660,8597,2935,1339,10896,3413,1426,2299,478,87,1412,.7116935,.7968804,.1656846,.030156,.6241016,.2130671,.0972051,26.54767
33026,57006,5699,9854,31074,40928,20915,9141,4594,29335,13344,5114,8420,4203,520,4620,.8106685,.8544753,.4265273,.0527704,.6730707,.2941688,.1478406,17.07237
33027,65150,7328,11047,34891,45938,23785,10560,5380,32972,14561,5759,9187,4001,379,6029,.8227347,.8316285,.3621798,.034308,.6816944,.3026569,.1541945,19.08638
33028,702238,53184,96342,414129,510471,297135,157745,88338,375872,197015,96690,78737,39270,8352,40435,.760285,.8172656,.4076104,.0866912,.7174938,.3809079,.2133103,9.842957
33029,53439,3361,5332,34230,39562,20759,7474,2889,24868,8969,3059,4109,1495,170,2513,.7476941,.7706302,.2803826,.031883,.6064563,.2183465,.0843996,18.36667
33030,1321582,102216,155763,827006,982769,642749,331034,195076,778052,404212,212837,135303,73178,17761,84844,.8300462,.8686466,.4698035,.1140258,.7771999,.4002801,.2358822,5.289818
33031,1428285,69794,162096,1013496,1175592,689346,478581,336370,809398,558114,370315,120052,79533,33945,51138,.7326991,.7406228,.4906537,.2094129,.6801665,.4722081,.3318908,24.04963
33032,227354,17553,29429,134770,164199,88496,33688,15476,112099,42402,16783,23603,8714,1307,12504,.7123569,.802032,.2961025,.044412,.6566446,.2499666,.1148327,10.14071
33033,253466,19179,31483,151257,182740,98304,41807,20005,123559,52454,21667,25255,10647,1662,14173,.7389854,.802179,.3381825,.0527904,.6499137,.2763971,.1322583,14.01038
33034,463920,37275,65837,269581,335418,195852,96998,52392,251097,125038,58274,55245,28040,5882,29358,.7876056,.8391178,.4259003,.0893419,.7265052,.3598102,.194346,11.25471
33035,88909,7023,11255,52411,63666,37187,16991,8068,46423,20683,8490,9236,3692,422,5342,.7606436,.8206131,.328032,.0374944,.7095266,.3241877,.1539371,15.164
33036,259603,20066,30293,149708,180001,101093,45306,22348,124996,55575,23750,23903,10269,1402,13783,.6868833,.7890602,.3389892,.0462813,.6752679,.3026291,.1492773,15.61399
33037,38496,3027,4310,22392,26702,13829,4956,2207,16854,5677,2339,3025,721,132,2162,.7142385,.7018561,.1672854,.0306264,.6175866,.221329,.098562,17.36371
33038,113901,10305,17583,60927,78510,38616,13990,6619,53079,20307,7441,14463,6317,822,7634,.7408054,.8225559,.3592675,.0467497,.6338077,.2296191,.1086382,18.48645
33039,59075,6154,11199,33398,44597,22621,10560,5420,32437,16407,5790,9816,5847,370,5181,.8418915,.8765068,.5221002,.0330387,.677316,.3161866,.1622852,22.93665
33040,77193,5743,7533,45230,52763,34991,16451,8811,40968,18856,9325,5977,2405,514,4470,.7783388,.7934422,.3192619,.0682331,.7736237,.3637188,.1948043,10.95685
33041,1891325,113797,208431,1246448,1454879,786507,363443,192969,947545,449506,214419,161038,86063,21450,86113,.7567247,.7726202,.4129088,.1029118,.6309987,.291583,.1548151,8.050292
33042,151966,12685,21762,88110,109872,58154,25310,12217,76663,34231,13649,18509,8921,1432,10020,.7899094,.8505192,.4099348,.0658028,.6600159,.2872546,.1386562,15.65891
33043,352121,24695,39792,209864,249656,143831,61426,31025,175405,75638,34064,31574,14212,3039,18338,.7425795,.7934761,.3571572,.0763721,.6853534,.2926943,.1478338,9.239089
33044,259530,20283,28195,151137,179332,115825,65291,38921,138797,77275,41565,22972,11984,2644,16951,.8357245,.8147544,.4250399,.0937755,.7663577,.4319988,.2575213,8.566895
33045,114254,12490,21149,59808,80957,38515,16575,7968,56683,26346,8827,18168,9771,859,10497,.8404323,.8590477,.4620077,.0406166,.6439774,.2771368,.1332263,22.78231
33046,153759,11635,17938,88086,106024,64469,31442,16381,79029,37510,17776,14560,6068,1395,9008,.7742158,.8116847,.3382763,.0777679,.731887,.3569466,.185966,17.21275
33047,149946,10300,16986,94522,111508,67590,31890,17293,81727,38347,18716,14137,6457,1423,7650,.7427185,.8322737,.3801366,.0837749,.7150716,.3373818,.1829521,13.1257
33048,29710,3618,5049,16697,21746,10712,4053,1919,14908,5630,2105,4196,1577,186,2943,.8134328,.8310556,.3123391,.036839,.6415524,.2427382,.1149308,26.78002
33049,17686,1428,1906,10404,12310,6641,2499,1173,7994,2871,1237,1353,372,64,1000,.7002801,.7098636,.1951731,.0335782,.6383122,.2401961,.1127451,20.1903
33050,33733,2568,4088,20216,24304,13283,5407,2458,16434,6449,2593,3151,1042,135,1859,.7239097,.7707925,.2548924,.0330235,.6570538,.2674614,.1215869,16.29602
33051,99217,7305,10463,58952,69415,39288,15696,7432,47255,18207,7921,7967,2511,489,5482,.7504449,.7614451,.2399885,.0467361,.6664405,.2662505,.1260687,19.72593
33052,1284231,104095,145543,732910,878453,540345,249795,130413,661194,302866,140038,120849,53071,9625,80824,.7764446,.8303319,.3646414,.0661317,.7372597,.3408263,.1779386,9.932737
33053,65155,5035,7097,41042,48139,25379,10797,4926,30460,12727,5320,5081,1930,394,3730,.7408143,.7159363,.2719459,.0555164,.6183665,.263072,.1200234,20.30297
33054,49812,3980,5224,28121,33345,20208,8263,4161,24177,9481,4363,3969,1218,202,3147,.7907035,.7597626,.2331547,.0386677,.7186089,.2938373,.1479677,17.16911
33055,87085,11056,24569,43872,68441,35440,22492,15933,58575,38474,19074,23135,15982,3141,9976,.9023155,.9416338,.6504945,.127844,.8078045,.5126733,.3631701,15.75976
33056,158158,11965,19586,96130,115716,64260,30590,15412,79657,37547,16601,15397,6957,1189,9074,.7583786,.7861227,.3552027,.0607066,.6684698,.3182149,.1603246,15.79737
33057,54854,4128,6174,32313,38487,22244,10157,5278,26950,11792,5564,4706,1635,286,3079,.7458818,.7622287,.2648202,.0463233,.6883917,.3143317,.1633398,21.65548
33058,54795,4324,6172,31680,37852,19785,7446,3269,23948,8662,3465,4163,1216,196,3206,.7414431,.6744977,.1970188,.0317563,.6245265,.2350379,.1031881,22.18833
33059,84581,6277,8938,49095,58033,31325,12438,5649,37556,14073,5982,6231,1635,333,4436,.706707,.6971358,.1829268,.0372567,.6380487,.2533455,.1150626,17.00628
33060,866599,61231,94516,554740,649256,416939,238224,155211,495176,281159,166371,78237,42935,11160,50204,.8199115,.8277646,.4542617,.1180752,.7515935,.4294336,.2797905,7.949345
33061,39895,2845,4469,23183,27652,14641,5245,1996,17957,5986,2100,3316,741,104,2049,.7202109,.7420005,.1658089,.0232714,.6315404,.2262434,.0860976,17.37491
33062,21459,1723,2570,12859,15429,8310,3367,1690,10350,4118,1734,2040,751,44,1310,.7603018,.7937743,.2922179,.0171206,.64624,.26184,.1314255,23.38812
34001,99319,7609,12258,61025,73283,32947,15434,7194,41843,18915,7807,8896,3481,613,5489,.7213826,.7257301,.2839778,.0500082,.5398935,.2529127,.1178861,23.39498
34002,24999,1876,2907,14597,17504,6404,2317,991,8237,2760,1060,1833,443,69,1086,.5788913,.6305469,.1523908,.0237358,.4387203,.1587313,.0678907,34.89651
34003,9587,618,943,6128,7071,2359,901,312,2971,1022,350,612,121,38,429,.6941748,.6489926,.1283139,.0402969,.3849543,.14703,.0509138,49.33673
34004,25649,1905,2809,14686,17495,6894,2504,1020,8859,3044,1089,1965,540,69,1249,.655643,.6995372,.1922392,.0245639,.4694267,.1705025,.0694539,59.31553
34005,22325,1517,2374,13975,16349,5733,2086,836,7234,2354,865,1501,268,29,861,.5675676,.6322662,.1128896,.0122157,.4102325,.1492665,.0598211,55.59979
34006,14409,1324,2075,8340,10415,4137,1795,789,5682,2365,817,1545,570,28,1004,.7583082,.7445783,.2746988,.013494,.4960432,.2152278,.0946043,57.24355
34007,40355,2806,4345,23942,28287,12080,4801,2051,15139,5722,2222,3059,921,171,2046,.7291518,.7040276,.2119678,.0393556,.5045527,.2005263,.0856654,61.40871
34008,21024,1669,2400,11847,14247,4491,1782,772,5927,2185,876,1436,403,104,1189,.7124026,.5983334,.1679167,.0433333,.3790833,.1504178,.0651642,64.87823
34009,30491,2293,3553,17518,21071,7694,3003,1225,10040,3688,1339,2346,685,114,1528,.6663759,.6602871,.1927948,.0320856,.4392054,.1714237,.0699281,62.59098
34010,35777,2433,3858,21014,24872,10829,4274,1683,13404,4960,1828,2575,686,145,1549,.6366625,.6674443,.1778123,.0375842,.5153231,.2033882,.0800895,59.54552
34011,160934,10656,17708,101638,119346,60368,30303,14858,72898,35213,15832,12530,4910,974,7102,.666479,.7075898,.2772758,.0550034,.5939511,.2981464,.1461855,31.46442
34012,72504,5725,8079,43464,51543,19989,8978,3840,24861,10581,4165,4872,1603,325,3399,.5937118,.6030449,.1984157,.0402278,.4598978,.2065618,.088349,31.45849
34013,85895,5957,9699,52379,62078,25676,11667,4518,32097,13764,4905,6421,2097,387,3878,.6509988,.662027,.2162079,.039901,.4901965,.2227419,.0862559,27.01078
34014,67746,5146,8057,39579,47636,17560,6879,3040,22140,8171,3264,4580,1292,224,2621,.5093277,.5684498,.1603575,.0278019,.4436696,.1738043,.0768084,35.59875
34015,5829,451,728,3391,4119,1513,581,167,2078,776,198,565,195,31,308,.6829268,.7760989,.2678571,.0425824,.4461811,.1713359,.049248,55.31245
34016,41092,2940,5309,24898,30207,14210,6829,3009,18066,7902,3240,3856,1073,231,1795,.6105442,.7263138,.2021096,.043511,.5707286,.2742791,.1208531,36.95235
34017,20705,1710,2531,12002,14533,4922,1683,617,6380,2045,708,1458,362,91,1278,.7473684,.5760569,.1430265,.0359542,.4100983,.1402266,.0514081,55.41543
34018,105208,7215,12552,62457,75009,32363,15392,7085,40993,18454,7625,8630,3062,540,4666,.6467083,.6875398,.2439452,.043021,.5181645,.2464416,.113438,24.6305
34019,33415,2125,3676,20824,24500,10730,5049,2699,13289,6083,2990,2559,1034,291,1401,.6592941,.6961371,.281284,.0791621,.5152708,.2424606,.1296101,40.92824
34020,18933,1207,1809,11803,13612,5148,1755,732,6417,2080,784,1269,325,52,794,.6578293,.7014925,.1796573,.0287452,.4361603,.148691,.0620181,58.66975
34021,12558,888,1353,7595,8948,3426,1491,596,4321,1807,641,895,316,45,732,.8243243,.661493,.2335551,.0332594,.4510863,.1963134,.0784727,57.32204
34022,6619,391,615,4296,4911,1994,872,422,2402,946,438,408,74,16,256,.6547315,.6634147,.1203252,.0260163,.4641527,.2029795,.0982309,68.26849
34023,83435,6345,9870,48742,58612,23107,10508,4461,29647,12673,4809,6540,2165,348,4090,.6446021,.662614,.2193516,.0352584,.4740675,.2155841,.0915227,39.73095
34024,51037,3910,5874,29446,35320,13002,5771,2372,16723,6923,2551,3721,1152,179,2906,.7432225,.6334695,.1961185,.0304733,.441554,.1959859,.0805542,57.42373
34025,71043,6129,13593,36436,50029,22183,10064,4255,32228,12079,4663,10045,2015,408,3041,.4961658,.7389833,.1482381,.0300154,.608821,.2762103,.1167801,44.46166
34026,247160,23550,54136,116793,170929,81298,38182,16593,123763,48847,18505,42465,10665,1912,11847,.5030573,.7844133,.1970038,.0353185,.6960862,.3269203,.1420719,41.16074
34027,11089,805,1263,6622,7885,3338,1012,322,4151,1312,363,813,300,41,502,.6236025,.6437055,.2375297,.0324624,.5040773,.1528239,.0486258,43.88344
34028,13377,750,1522,8676,10198,5617,2776,1334,6829,3138,1432,1212,362,98,509,.6786667,.7963206,.2378449,.064389,.6474181,.3199631,.1537575,43.597
34029,113162,8229,13116,67579,80695,31889,13286,5593,40325,15980,6015,8436,2694,422,5073,.6164783,.6431839,.205398,.0321744,.4718774,.1965995,.0827624,27.75183
34030,24599,1711,2467,15005,17472,7578,3066,1488,9294,3568,1572,1716,502,84,1225,.7159556,.6955817,.203486,.0340495,.5050316,.2043319,.0991669,33.87738
34031,40952,3302,4800,23809,28609,10403,4133,1637,13424,4895,1776,3021,762,139,2190,.6632344,.629375,.15875,.0289583,.4369356,.1735898,.0687555,62.38121
34032,152785,12334,25403,88524,113927,57617,35261,21344,78705,48360,24693,21088,13099,3349,9704,.7867683,.8301381,.5156478,.1318348,.6508631,.3983214,.2411098,29.49446
34033,55988,4691,6815,31308,38123,14287,5453,2362,18150,6441,2604,3863,988,242,3264,.6958005,.5668378,.1449743,.0355099,.456337,.1741727,.075444,57.94262
34034,243683,18687,32667,146644,179311,91957,48834,26803,117453,60638,29990,25496,11804,3187,14263,.7632579,.7804818,.3613433,.0975602,.6270764,.3330106,.182776,22.93268
34035,30055,2542,3745,17814,21559,7695,3110,1243,10183,3947,1376,2488,837,133,1997,.7856019,.6643525,.223498,.035514,.4319636,.1745818,.0697766,59.74353
34036,162568,11592,19155,95597,114752,44090,20871,8299,55004,24625,8893,10914,3754,594,7100,.6124914,.5697729,.1959802,.0310102,.4612069,.2183228,.0868123,29.33053
34037,8875,627,998,5329,6327,2287,957,381,2916,1205,419,629,248,38,445,.7097289,.6302605,.248497,.0380762,.4291612,.1795834,.0714956,61.61017
34038,7217,490,722,4324,5046,1729,589,261,2255,697,275,526,108,14,311,.6346939,.7285318,.1495845,.0193906,.3998612,.1362165,.0603608,56.23375
34039,34043,2782,3944,20301,24245,9012,3687,1436,11376,4454,1548,2364,767,112,1878,.6750539,.5993915,.1944726,.0283976,.443919,.1816167,.0707354,52.56042
34040,16117,1340,2282,8906,11188,3786,1368,540,5234,1719,594,1448,351,54,832,.6208955,.6345311,.1538124,.0236635,.4251067,.1536043,.0606333,73.68549
34041,317154,24724,45607,186981,232588,118273,67939,36767,153972,85786,40563,35699,17847,3796,18363,.7427197,.7827526,.3913215,.0832328,.6325402,.3633471,.1966349,23.22389
34042,55286,4318,6444,31802,38246,13563,5441,2467,17237,6495,2714,3674,1054,247,2979,.6899027,.5701427,.163563,.0383302,.4264826,.1710899,.0775737,61.17772
34043,59570,5056,9660,32685,42345,15486,6416,2889,22315,8640,3236,6829,2224,347,3275,.6477453,.7069358,.2302277,.0359213,.4737953,.196298,.0883892,52.25846
34044,46495,3230,4862,29543,34405,15241,6412,2718,18559,7504,2886,3318,1092,168,2225,.6888545,.6824352,.2245989,.0345537,.5158921,.2170396,.0920015,31.5816
34045,58580,3549,5500,38061,43561,23420,11349,5768,27018,12424,5957,3598,1075,189,2442,.6880811,.6541818,.1954546,.0343636,.615328,.2981792,.1515462,33.74309
34046,23368,2292,3312,13123,16435,5971,2932,1364,8237,3691,1481,2266,759,117,1832,.7993019,.6841788,.2291667,.0353261,.4550027,.2234245,.1039396,59.14669
34047,20383,1744,2922,10291,13213,4886,1926,912,6649,2267,1006,1763,341,94,1053,.6037844,.6033539,.1167009,.0321697,.4747838,.1871538,.0886211,63.3279
34048,5873,444,700,3416,4116,1451,666,295,1813,809,318,362,143,23,323,.7274775,.5171428,.2042857,.0328571,.4247658,.1949649,.0863583,68.07997
34049,82538,5974,9078,49592,58670,24843,10865,4560,30702,12802,4875,5859,1937,315,3993,.6683964,.6454065,.213373,.0346993,.5009477,.2190877,.0919503,32.26231
34050,25811,2942,5747,13859,19606,7299,3878,2144,12412,6720,2409,5113,2842,265,2457,.8351462,.8896816,.4945189,.046111,.5266614,.2798182,.1547009,51.1729
34051,70599,4921,7742,42390,50132,19768,7749,3018,25162,9192,3309,5394,1443,291,3453,.7016866,.6967192,.1863859,.0375872,.4663364,.1828025,.071196,56.98075
34052,9705,814,1194,5531,6725,2313,854,319,3063,1156,369,750,302,50,630,.7739558,.6281407,.2529313,.041876,.4181884,.1544025,.0576749,63.39993
34053,36718,2838,4451,21513,25964,12242,5876,2469,15311,6884,2655,3069,1008,186,1914,.6744186,.689508,.226466,.0417884,.5690513,.2731372,.1147678,37.66893
34054,59819,4478,7082,34846,41928,18185,8259,3587,22764,9790,3833,4579,1531,246,3308,.7387226,.6465688,.2161819,.034736,.5218676,.2370143,.1029386,50.7877
34055,42372,2945,4813,25095,29908,11759,4982,2089,14778,5827,2217,3019,845,128,1812,.6152802,.6272595,.1755662,.0265946,.4685794,.1985256,.0832437,36.67226
34056,35135,2365,3960,21080,25040,9743,3927,1670,12104,4508,1774,2361,581,104,1320,.5581396,.5962121,.1467172,.0262626,.4621916,.1862903,.079222,40.21492
34057,20178,1348,1791,13416,15207,7028,3005,1395,8166,3367,1501,1138,362,106,996,.7388724,.6353992,.2021217,.0591848,.5238521,.2239863,.1039803,57.24817
34058,16827,1413,2453,10075,12528,4188,1763,952,6076,2596,1034,1888,833,82,1054,.7459307,.7696698,.3395842,.0334285,.4156824,.1749876,.0944913,58.38605
34059,25948,1861,2935,15029,17964,6729,2915,1246,8796,3600,1377,2067,685,131,1358,.7297152,.7042589,.2333901,.0446337,.4477344,.1939583,.0829064,64.49486
34060,404270,29970,54657,237289,291946,164490,99466,50338,205695,119961,55164,41205,20495,4826,22134,.7385386,.7538833,.3749748,.0882961,.6932054,.4191766,.2121379,24.68117
34061,14428,1001,1522,9229,10751,3975,1533,750,5042,1781,770,1067,248,20,638,.6373627,.7010512,.1629435,.0131406,.4307075,.1661068,.0812656,53.69103
34062,22469,1541,2592,13238,15830,5600,2295,945,7181,2742,1051,1581,447,106,958,.6216742,.6099537,.1724537,.0408951,.4230246,.1733645,.0713854,46.74398
34063,50505,3442,5802,31078,36880,18126,9664,4788,22280,11303,5052,4154,1639,264,2463,.7155724,.71596,.2824888,.0455016,.5832422,.3109595,.154064,43.242
34064,67153,5277,7833,39389,47222,19819,8754,4353,24851,10172,4605,5032,1418,252,3581,.6786053,.6424103,.181029,.0321716,.5031608,.2222448,.1105131,54.62598
34065,103471,7805,13593,61075,74668,39665,20128,9969,49686,24547,10751,10021,4419,782,5853,.7499039,.7372177,.3250938,.0575296,.6494474,.329562,.1632255,36.42181
34066,22584,1935,2865,13180,16045,4750,1919,802,6511,2530,853,1761,611,51,1495,.7726098,.6146597,.2132635,.017801,.3603945,.1455994,.0608498,67.04299
34067,112784,14516,38603,43946,82549,29179,11478,4997,59863,15797,5658,30684,4319,661,4249,.2927115,.7948605,.1118825,.017123,.663974,.2611842,.1137077,40.25433
34068,77055,8470,21420,39871,61291,29362,21706,16452,48959,35531,19890,19597,13825,3438,7432,.8774498,.9148926,.6454248,.1605042,.736425,.5444057,.4126307,34.6404
34069,10398,756,1085,6291,7376,3017,1243,510,3690,1469,534,673,226,24,553,.7314815,.6202765,.2082949,.0221198,.479574,.1975839,.0810682,54.25182
34070,28462,2548,4753,15894,20647,8129,4291,2045,11628,5867,2198,3499,1576,153,1752,.6875981,.7361667,.33158,.0321902,.5114509,.2699761,.1286649,44.78785
34071,22215,1611,2280,13178,15458,6247,2373,948,7803,2834,1027,1556,461,79,1097,.6809435,.6824561,.202193,.0346491,.4740477,.1800728,.0719381,62.38837
34072,9486,694,1089,5778,6867,2398,930,351,3115,1129,374,717,199,23,453,.6527377,.6584022,.1827365,.0211203,.4150225,.1609554,.0607477,61.74171
34073,29164,2189,3476,17248,20724,7838,3072,1249,10081,3758,1358,2243,686,109,1471,.6719964,.6452819,.1973533,.0313579,.4544295,.1781076,.0724142,47.05704
34074,90146,9221,19721,47013,66734,26683,15099,8322,43533,25154,9945,16850,10055,1623,7547,.8184578,.8544192,.5098626,.0822981,.5675664,.3211665,.1770149,59.36287
34075,12984,798,1147,8727,9874,5106,2788,1496,5839,3049,1533,733,261,37,526,.6591479,.6390584,.2275501,.0322581,.5850808,.3194683,.171422,45.28789
34076,91728,6491,10345,55552,65897,25862,9628,4205,32303,11497,4601,6441,1869,396,3925,.6046834,.6226196,.180667,.0382794,.4655458,.1733151,.0756948,27.61705
34077,45481,3418,5383,26610,31993,12347,4901,2124,15609,5769,2324,3262,868,200,2232,.6530135,.6059818,.1612484,.037154,.4639985,.1841789,.0798196,43.63969
34078,101610,8644,12921,53240,66161,23638,9865,4623,31670,12377,5091,8032,2512,468,5704,.6598797,.6216237,.1944122,.0362201,.4439895,.185293,.0868332,65.97923
34079,83426,5753,9545,50139,59684,22347,9699,3987,28233,11558,4424,5886,1859,437,3568,.6201981,.6166579,.1947616,.0457831,.4457009,.1934422,.0795189,33.95369
34080,99186,6936,12081,61434,73515,30365,14052,6421,39022,17397,6833,8657,3345,412,4732,.6822376,.7165797,.276881,.0341031,.4942703,.2287333,.1045187,28.50047
34081,53787,3609,5469,32835,38304,14728,6259,2704,18187,7368,2937,3459,1109,233,2360,.6539208,.6324739,.2027793,.0426038,.4485458,.1906198,.0823511,41.24569
34082,49687,3682,5556,29138,34694,13315,5195,2049,17193,6285,2287,3878,1090,238,2548,.6920152,.6979842,.1961843,.0428366,.4569634,.1782895,.0703205,60.76
34083,32273,2490,4218,17365,21583,8292,3895,1941,11167,4907,2073,2875,1012,132,1724,.6923695,.6816027,.2399241,.0312945,.4775122,.2243018,.1117766,59.76548
34084,48517,3551,5688,29660,35348,13770,5752,2431,17781,6884,2612,4011,1132,181,2495,.702619,.7051688,.1990155,.0318214,.4642616,.1939312,.0819622,30.40365
34085,33086,2303,3490,19521,23011,8767,2440,1063,11154,3005,1181,2387,565,118,1498,.650456,.6839542,.1618911,.0338109,.4491061,.1249936,.0544542,39.32084
34086,59449,4138,6539,36345,42884,14899,5722,2278,18968,6905,2472,4069,1183,194,2612,.6312228,.6222664,.1809145,.0296681,.4099326,.1574357,.0626771,36.10609
34087,10283,768,1178,6127,7305,2727,1165,539,3395,1389,552,668,224,13,432,.5625,.5670628,.1901528,.0110357,.4450791,.190142,.0879713,61.61494
34088,23417,1928,2811,14098,16909,8356,3867,1988,10419,4618,2103,2063,751,115,1455,.7546681,.7339025,.2671647,.0409107,.5927082,.2742942,.1410129,38.98273
34089,3975,293,479,2346,2825,841,334,147,1157,412,152,316,78,5,190,.6484641,.6597077,.1628392,.0104384,.3584825,.14237,.0626598,68.62578
34090,70380,5599,8794,39294,48088,20761,8742,3589,26541,10830,3840,5780,2088,251,3957,.7067333,.6572663,.2374346,.0285422,.5283504,.2224767,.0913371,40.1743
34091,36748,2576,4114,21273,25387,9203,3970,1650,11429,4707,1753,2226,737,103,1769,.6867236,.5410792,.1791444,.0250365,.4326141,.1866215,.0775631,54.37306
34092,301327,25053,49257,172846,222103,125357,80615,45948,166030,104634,50826,40673,24019,4878,19839,.7918812,.8257303,.4876261,.0990316,.7252525,.4663978,.265832,31.60935
34093,16232,1292,1831,9588,11419,3589,1465,606,4793,1750,670,1204,285,64,928,.7182662,.6575642,.1556526,.0349536,.3743221,.1527952,.063204,67.36153
34094,14801,1155,1801,8209,10010,3903,1548,701,5027,1915,766,1124,367,65,891,.7714286,.6240977,.2037757,.0360911,.4754538,.1885735,.0853941,51.76188
34095,31666,4123,8951,15966,24917,9601,5614,3340,17838,10920,3801,8237,5306,461,3595,.8719379,.9202324,.5927829,.0515026,.6013404,.3516222,.2091945,55.47097
34096,97054,8038,14263,53415,67678,30366,13657,5793,40947,16497,6240,10581,2840,447,5517,.6863648,.7418495,.1991166,.0313398,.568492,.2556773,.1084527,52.96768
34097,58657,4169,6829,34978,41807,15170,5872,2577,19506,7085,2772,4336,1213,195,2565,.6152555,.6349393,.1776248,.0285547,.4337012,.1678769,.0736749,50.27771
34098,63132,4955,8443,36035,44478,17295,7838,4079,23200,10203,4496,5905,2365,417,3509,.7081736,.699396,.2801137,.04939,.47995,.2175108,.1131955,54.54463
34099,28439,1897,3027,17872,20899,7575,2399,899,9440,2949,997,1865,550,98,1212,.6389036,.6161216,.1816981,.0323753,.4238473,.1342323,.0503021,33.96243
34100,14934,907,1472,9328,10800,4013,1493,617,5013,1717,685,1000,224,68,566,.6240353,.6793478,.1521739,.0461957,.4302101,.1600557,.0661449,58.14404
35001,3584,227,351,2208,2559,1499,694,234,1789,796,247,290,102,13,152,.6696035,.8262108,.2905983,.037037,.6788949,.3143116,.1059783,26.75706
35002,13960,1188,2004,8243,10247,5424,2794,1220,7195,3680,1282,1771,886,62,988,.8316498,.8837326,.4421158,.0309381,.6580129,.3389543,.1480044,24.15471
35003,7944,597,736,4316,5052,2382,1064,386,2888,1251,410,506,187,24,440,.7370184,.6875,.2540761,.0326087,.5518999,.2465246,.0894347,38.5323
35004,1138,105,129,631,760,387,178,66,490,203,66,103,25,0,75,.7142857,.7984496,.1937985,0,.6133122,.2820919,.1045959,46.51493
35005,9239,770,1103,5557,6660,3328,1682,613,4243,2035,651,915,353,38,584,.7584416,.8295557,.3200363,.0344515,.5988843,.3026813,.1103113,21.20578
35006,4229,322,455,2407,2862,1612,797,270,1987,921,289,375,124,19,234,.7267081,.8241758,.2725275,.0417582,.6697133,.3311176,.1121728,23.32231
35007,3822,239,277,2480,2757,1490,681,227,1714,746,242,224,65,15,169,.707113,.8086643,.234657,.0541516,.6008065,.2745968,.0915323,33.11313
35008,54811,4457,8606,29850,38456,22908,13938,6664,30345,17529,7356,7437,3591,692,3299,.740184,.8641645,.417267,.080409,.7674372,.4669347,.2232496,19.1739
35009,88247,6946,16782,48434,65216,37903,22347,10766,52809,31169,12098,14906,8822,1332,5501,.7919666,.8882136,.5256823,.0793708,.7825701,.4613908,.2222819,14.50317
35010,7636,595,716,4671,5387,2889,1412,514,3389,1606,533,500,194,19,449,.7546219,.698324,.2709497,.0265363,.6184971,.3022907,.1100407,31.30336
35011,7207,485,799,4301,5100,2608,1382,472,3278,1684,519,670,302,47,377,.7773196,.8385482,.3779725,.0588235,.6063706,.3213206,.1097419,32.99667
35012,3494,223,271,2319,2590,1353,631,214,1566,729,231,213,98,17,173,.7757847,.7859778,.3616236,.0627306,.5834411,.2721,.0922812,33.63685
35013,4627,365,516,2597,3113,1510,703,189,1920,840,227,410,137,38,240,.6575342,.7945737,.2655039,.0736434,.5814402,.270697,.0727763,41.36445
35014,3554,244,318,2261,2579,1265,654,234,1510,763,253,245,109,19,171,.7008197,.7704403,.3427673,.0597484,.5594869,.2892525,.103494,32.02132
35015,5877,497,469,3462,3931,1519,640,298,1844,772,318,325,132,20,396,.7967807,.6929638,.2814499,.0426439,.4387637,.1848642,.0860774,41.1744
35016,4611,339,485,2720,3205,1637,834,309,2031,994,338,394,160,29,255,.7522124,.8123711,.3298969,.0597938,.6018382,.3066176,.1136029,26.37788
35017,2391,173,207,1424,1631,971,550,217,1118,623,232,147,73,15,159,.9190751,.7101449,.352657,.0724638,.681882,.386236,.1523876,38.58894
35018,66100,6170,15539,32198,47737,24525,14208,7272,38613,21686,8517,14088,7478,1245,4365,.7074555,.9066221,.4812407,.080121,.7616933,.4412696,.2258525,14.23886
35019,4274,289,341,2579,2920,1251,626,197,1504,713,224,253,87,27,255,.8823529,.7419355,.255132,.0791789,.4850717,.2427297,.0763862,45.40808
35020,3714,222,301,2451,2752,1486,701,217,1721,786,239,235,85,22,173,.7792793,.7807309,.282392,.0730897,.6062831,.2860057,.0885353,27.2598
35021,4275,327,388,2617,3005,1415,684,256,1731,802,275,316,118,19,253,.7737003,.814433,.3041237,.0489691,.5406954,.261368,.0978219,32.44043
35022,3833,261,342,2297,2639,1167,531,210,1421,603,230,254,72,20,184,.7049809,.7426901,.2105263,.0584795,.508054,.2311711,.0914236,45.92416
35023,6473,432,570,3989,4559,2276,1100,400,2723,1248,420,447,148,20,332,.7685185,.7842105,.2596491,.0350877,.570569,.2757583,.1002758,32.06689
35024,3493,263,277,2164,2441,850,386,107,1053,444,119,203,58,12,231,.878327,.732852,.2093863,.0433213,.3927911,.1783734,.0494455,48.9498
35025,7858,582,687,4862,5549,2642,1211,392,3181,1404,431,539,193,39,456,.7835051,.7845706,.2809316,.0567686,.5433978,.2490745,.0806253,35.95893
35026,4800,339,375,3287,3662,1207,643,210,1476,756,245,269,113,35,282,.8318584,.7173333,.3013333,.0933333,.3672041,.1956191,.063888,46.38462
35027,7132,533,893,3862,4755,2418,1166,382,3095,1409,401,677,243,19,316,.5928705,.7581187,.2721165,.0212766,.6261005,.3019161,.0989125,28.90101
35028,12383,748,1189,7344,8533,4454,2154,825,5417,2536,900,963,382,75,536,.7165775,.8099243,.3212784,.0630782,.6064815,.2933007,.1123366,37.35949
35029,9404,623,1147,5314,6461,3051,1559,566,3981,1862,606,930,303,40,439,.7046549,.8108108,.2641674,.0348736,.5741438,.293376,.1065111,35.31752
35030,25177,1991,3143,13743,16886,8271,3885,1586,10794,4683,1720,2523,798,134,1266,.6358614,.8027362,.2538975,.0426344,.6018336,.2826894,.1154042,33.00729
35031,7679,541,702,4575,5277,2825,1317,446,3329,1514,479,504,197,33,387,.715342,.7179487,.2806268,.0470085,.6174864,.2878689,.0974863,35.90073
35032,5233,336,366,3541,3907,2176,969,315,2455,1081,347,279,112,32,289,.860119,.7622951,.3060109,.0874317,.6145157,.2736515,.0889579,26.49322
35033,2495,198,267,1377,1644,749,318,84,962,375,100,213,57,16,158,.7979798,.7977528,.2134831,.0599251,.5439361,.2309368,.0610022,53.39254
35034,10399,664,930,6416,7346,3896,1933,748,4605,2284,818,709,351,70,510,.7680723,.7623656,.3774194,.0752688,.6072319,.3012781,.1165835,30.88903
35035,6166,484,560,3612,4172,1903,967,297,2340,1138,333,437,171,36,393,.8119835,.7803571,.3053571,.0642857,.5268549,.2677187,.0822259,30.74509
35036,13048,1127,1582,7668,9250,5090,2704,1003,6407,3238,1094,1317,534,91,912,.8092281,.8324905,.3375474,.0575221,.6637976,.3526343,.1308033,23.49055
35037,6698,454,585,4225,4810,2635,1194,446,3082,1355,470,447,161,24,323,.7114537,.7641026,.2752137,.0410256,.6236686,.2826036,.1055621,29.30333
35038,3608,227,299,2213,2512,1457,725,226,1705,810,240,248,85,14,162,.7136564,.8294314,.2842809,.0468227,.6583823,.3276096,.1021238,26.01921
35039,19207,2385,4087,10289,14376,6509,3429,1110,10257,5040,1181,3748,1611,71,2133,.8943396,.9170541,.3941767,.0173722,.6326174,.3332686,.1078822,31.88552
35040,12177,1105,1421,5846,7267,2841,1444,562,3678,1669,602,837,225,40,683,.6180996,.5890218,.1583392,.0281492,.4859733,.2470065,.0961341,50.77187
35041,5512,394,532,3284,3816,2070,860,252,2492,1044,283,422,184,31,329,.8350254,.7932331,.3458647,.0582707,.6303289,.2618757,.0767357,39.31662
35042,2819,188,245,1800,2045,802,362,125,963,413,133,161,51,8,137,.7287234,.6571429,.2081633,.0326531,.4455556,.2011111,.0694444,50.73333
35043,3620,310,400,1592,1992,866,338,142,1147,419,152,281,81,10,218,.7032258,.7025,.2025,.025,.5439699,.2123116,.089196,63.3156
35044,1157,100,110,665,775,423,238,75,500,277,83,77,39,8,88,.88,.7,.3545454,.0727273,.6360902,.3578947,.112782,25.5132
35045,23697,2125,4043,12138,16181,7674,4018,1754,11136,5548,1973,3462,1530,219,1540,.7247059,.8562948,.3784319,.0541677,.6322294,.3310265,.1445049,31.68229
35046,3106,224,257,1948,2205,1271,645,246,1474,741,259,203,96,13,191,.8526786,.7898833,.3735408,.0505837,.6524641,.3311088,.1262834,20.61768
35047,24154,1710,3148,14194,17342,9069,4280,1957,11667,5321,2184,2598,1041,227,1163,.680117,.8252859,.3306862,.0721093,.6389319,.3015359,.1378752,26.17497
35048,4052,281,387,2550,2937,1601,767,266,1905,917,303,304,150,37,228,.8113879,.7855297,.3875969,.0956072,.6278431,.3007843,.1043137,20.80665
35049,9624,793,1317,5781,7098,3738,2080,826,4879,2772,903,1141,692,77,677,.8537201,.8663629,.5254366,.0584662,.646601,.3597994,.1428819,22.25436
35050,15371,1066,1453,9553,11006,5124,2337,826,6022,2733,917,898,396,91,802,.7523452,.6180317,.2725396,.062629,.536376,.2446352,.086465,22.42896
35051,58392,4553,10304,30135,40439,22548,11757,4882,31455,15184,5414,8907,3427,532,3037,.6670327,.8644216,.3325893,.0516304,.748233,.3901443,.1620043,18.48127
35052,6979,486,585,4408,4993,2409,1101,396,2848,1232,424,439,131,28,390,.8024691,.7504274,.2239316,.0478632,.5465063,.2497731,.0898367,32.1175
35053,22237,1791,3456,12203,15659,8681,4315,1545,11609,5460,1710,2928,1145,165,1060,.5918481,.8472222,.3313079,.0477431,.7113824,.3536016,.1266082,21.1463
36001,24328,1821,2800,13622,16422,6520,1612,734,8337,1941,793,1817,329,59,1153,.6331686,.6489286,.1175,.0210714,.4786375,.118338,.0538834,47.09843
36002,112241,8469,14064,63871,77935,43125,14058,6373,53570,16610,6890,10445,2552,517,6214,.7337348,.7426763,.1814562,.0367605,.6751891,.2200999,.0997792,18.96083
36003,46178,3606,6258,26416,32674,18303,6240,3277,23303,7973,3493,5000,1733,216,2626,.7282307,.7989773,.2769255,.0345158,.6928755,.2362205,.1240536,15.73239
36004,104215,7674,11714,60719,72433,39836,11260,4910,48137,12989,5192,8301,1729,282,5331,.6946834,.7086393,.1476012,.0240738,.6560714,.1854444,.0808643,16.73923
36005,56399,6947,15528,27675,43203,18797,8909,5629,32964,17640,6500,14167,8731,871,6182,.8898805,.9123519,.5622746,.0560922,.6792051,.3219151,.2033966,32.39016
36006,42554,3080,5029,24385,29414,16402,4607,2051,20372,5423,2182,3970,816,131,2225,.7224026,.7894214,.1622589,.0260489,.6726266,.1889276,.0841091,16.58726
36007,82569,5622,9282,50981,60263,31971,8308,3801,39134,10096,4168,7163,1788,367,4030,.7168267,.7717087,.1926309,.0395389,.627116,.1629627,.0745572,23.31113
36008,31920,2412,3572,18064,21636,9652,2469,1256,12214,2860,1295,2562,391,39,1553,.643864,.7172452,.1094625,.0109183,.5343224,.1366807,.0695306,31.77798
36009,258787,22498,41313,142747,184060,92409,37785,20100,125531,51919,21867,33122,14134,1767,16575,.7367321,.8017331,.3421199,.042771,.6473621,.2646991,.1408086,13.15817
36010,25598,1896,2832,14746,17578,9245,2146,908,11202,2455,944,1957,309,36,1265,.6671941,.6910311,.1091102,.0127119,.6269497,.145531,.061576,21.32599
36011,33649,2457,3899,19687,23586,12620,3453,1710,15511,4083,1797,2891,630,87,1727,.7028897,.7414722,.1615799,.0223134,.6410322,.1753949,.0868593,24.04453
36012,150236,11338,18975,87839,106814,57361,19760,9288,71575,24531,9914,14214,4771,626,7914,.6980067,.7490909,.2514361,.0329908,.6530243,.224957,.1057389,17.40034
36013,128483,9430,16111,69648,85759,42727,15342,7259,54296,17956,7720,11569,2614,461,6178,.6551431,.7180808,.1622494,.028614,.6134706,.2202791,.1042241,15.30284
36014,34603,2674,4498,19776,24274,12672,4109,2134,16132,5078,2293,3460,969,159,1888,.7060583,.7692308,.2154291,.035349,.6407767,.2077771,.1079086,25.22026
36015,113572,7994,12847,67279,80126,42468,12602,5724,51954,14721,6099,9486,2119,375,5687,.7114086,.7383825,.1649412,.0291897,.6312222,.1873096,.0850786,19.10759
36016,36024,2538,3857,21488,25345,13726,3692,1907,16551,4128,2031,2825,436,124,1596,.6288416,.7324345,.1130412,.0321493,.6387751,.1718168,.0887472,23.65746
36017,50075,3503,5796,29467,35263,19337,5128,2227,23401,5899,2352,4064,771,125,2454,.7005424,.7011732,.1330228,.0215666,.6562256,.1740252,.0755761,15.66164
36018,1498400,103922,184818,925799,1110617,617960,277004,145576,760262,333198,159555,142302,56194,13979,76393,.7350994,.7699575,.3040505,.0756366,.6674883,.2992053,.1572436,12.17287
36019,55096,4002,6078,31652,37730,20174,4960,2482,24609,5666,2689,4435,706,207,2908,.7266367,.7296808,.1161566,.0340573,.6373689,.1567042,.0784153,20.37938
36020,39987,3136,5293,21614,26907,14485,4733,2376,18506,5938,2583,4021,1205,207,2206,.7034439,.7596826,.2276592,.0391083,.6701675,.2189784,.1099287,15.91926
36021,53840,4931,7642,30218,37860,22590,9615,5635,28805,12063,5956,6215,2448,321,3931,.7972014,.8132688,.320335,.0420047,.7475677,.3181878,.1864783,18.87563
36022,79655,5988,9447,46522,55969,31633,10839,5318,38777,12945,5836,7144,2106,518,4392,.7334669,.7562189,.2229279,.0548322,.6799579,.2329865,.1143115,13.96296
36023,93678,6767,9647,54372,64019,37947,12548,6279,44964,14147,6594,7017,1599,315,4963,.7334121,.7273764,.165751,.0326526,.6979144,.2307805,.1154822,17.653
36024,27467,1763,3112,16281,19393,9326,2455,1189,11354,2776,1272,2028,321,83,1183,.6710153,.6516709,.1031491,.026671,.5728149,.1507893,.0730299,30.62788
36025,869132,68287,142830,490385,633215,357837,181905,103940,472485,238610,117710,114648,56705,13770,49749,.7285281,.8026885,.3970104,.0964083,.7297062,.3709432,.2119559,15.25831
36026,37751,2898,4332,21074,25406,14568,4297,1961,17934,4991,2077,3366,694,116,2097,.7236025,.7770083,.1602031,.0267775,.6912783,.2039005,.0930531,13.95825
36027,30098,2321,4000,17474,21474,9645,3039,1529,12477,3743,1639,2832,704,110,1479,.6372253,.708,.176,.0275,.5519629,.1739155,.0875014,35.3307
36028,74474,5699,7483,42324,49807,32458,15665,8696,37859,17136,8955,5401,1471,259,4087,.7171434,.7217693,.1965789,.0346118,.7668935,.370121,.2054626,13.24989
36029,129769,11265,19256,72598,91854,54961,26050,15288,70852,32854,16425,15891,6804,1137,8775,.7789614,.8252493,.3533444,.0590465,.7570594,.3588253,.2105843,13.08076
36030,42024,2706,4703,24999,29702,15296,4285,2061,18682,5063,2240,3386,778,179,1669,.6167775,.719966,.1654263,.0380608,.6118644,.1714069,.0824433,25.30254
36031,873224,66034,118498,511956,630454,332954,166913,95530,423791,206520,105589,90837,39607,10059,48499,.734455,.7665699,.3342419,.0848875,.6503567,.32603,.1865981,15.99183
36032,64581,4764,8041,37196,45237,28191,10745,5461,34611,12851,5961,6420,2106,500,3553,.7458019,.7984082,.2619077,.0621813,.7579041,.2888752,.1468169,15.71793
36033,32719,2948,5652,17855,23507,11828,3455,1862,16268,5497,2307,4440,2042,445,2210,.7496608,.7855626,.361288,.0787332,.6624475,.1935032,.1042845,27.07512
36034,18152,1281,1990,10905,12895,6594,1379,595,8049,1633,649,1455,254,54,874,.6822795,.7311558,.1276382,.0271357,.6046768,.1264558,.0545621,26.63328
36035,28383,2070,3459,16233,19692,10585,2838,1270,13233,3331,1341,2648,493,71,1480,.7149758,.7655392,.1425267,.0205262,.6520668,.1748291,.0782357,15.24112
36036,33477,2324,3560,19848,23408,11392,2878,1350,13922,3306,1442,2530,428,92,1596,.686747,.7106742,.1202247,.0258427,.5739621,.145002,.0680169,34.74773
36037,24304,1755,2823,14117,16940,8557,2111,1010,10638,2464,1087,2081,353,77,1161,.6615385,.7371591,.1250443,.0272759,.6061486,.149536,.0715449,28.91763
36038,29416,2314,3547,14887,18434,6361,1853,998,7726,2060,1048,1365,207,50,852,.3681936,.3848323,.0583592,.0140964,.4272856,.124471,.0670384,35.61587
36039,54608,4064,6429,30525,36954,20603,5838,2724,25313,6693,2916,4710,855,192,2964,.7293307,.7326179,.1329911,.0298647,.674955,.1912531,.0892383,16.93142
36040,30592,2133,3520,17815,21335,9599,2671,1383,11971,3198,1497,2372,527,114,1367,.6408814,.6738636,.1497159,.0323864,.5388156,.1499298,.0776312,33.50375
36041,91564,6560,10649,56118,66767,34971,9764,4285,43099,11907,4686,8128,2143,401,4887,.7449695,.7632642,.2012396,.0376561,.6231691,.1739905,.076357,16.40522
36042,46304,4069,6966,26710,33676,18002,5735,2850,23752,8109,3167,5750,2374,317,3101,.7621037,.8254378,.3407982,.0455067,.6739798,.2147136,.1067016,18.21496
36043,212801,15413,25371,124039,149410,91636,36454,17569,112144,42879,18848,20508,6425,1279,11538,.7485889,.8083245,.2532419,.0504119,.7387676,.2938914,.1416409,7.213184
36044,63849,4611,7149,37086,44235,21455,5940,2424,26578,7016,2641,5123,1076,217,3216,.6974626,.7166037,.1505106,.0303539,.5785202,.1601683,.0653616,28.4486
36045,120981,9831,15413,69845,85258,47461,15831,7855,59458,19423,8343,11997,3592,488,7424,.7551622,.7783689,.23305,.0316616,.6795189,.226659,.1124633,15.56817
36046,39155,2702,4187,23295,27482,15231,4028,2032,18337,4589,2155,3106,561,123,1831,.6776462,.7418199,.1339861,.0293766,.6538313,.1729126,.087229,22.49682
36047,274909,21559,35391,151868,187259,101809,36516,16570,128432,44224,17554,26623,7708,984,16126,.7479939,.7522534,.2177955,.0278037,.6703782,.2404456,.1091079,13.44151
36048,471741,34374,62697,273410,336107,182511,79188,38288,230543,96681,41806,48032,17493,3518,24170,.7031477,.7660972,.2790086,.0561111,.667536,.2896309,.1400388,14.70155
36049,33004,2344,4104,19133,23237,11605,3391,1412,14289,4006,1519,2684,615,107,1600,.6825939,.6539961,.1498538,.0260721,.6065437,.1772331,.0737992,22.22495
36050,289487,20310,35509,176240,211749,115468,41771,19116,143786,51876,20797,28318,10105,1681,15336,.755096,.797488,.2845757,.0473401,.6551747,.237012,.1084657,14.58897
36051,67974,4759,8173,39496,47669,25842,8012,3929,31423,9261,4221,5581,1249,292,3324,.6984661,.6828582,.1528203,.0357274,.6542941,.202856,.0994784,16.76583
36052,113150,8465,12012,63395,75407,48125,18936,9743,57216,21074,10128,9091,2138,385,6132,.7243946,.7568265,.1779887,.0320513,.7591293,.2986986,.1536872,11.81643
36053,23641,1640,2545,14006,16551,7756,1822,840,9527,2061,867,1771,239,27,1109,.6762195,.6958743,.0939096,.010609,.5537627,.1300871,.0599743,38.98547
36054,38334,3084,4916,20782,25698,13169,3371,1717,17064,4046,1844,3895,675,127,2223,.7208171,.7923108,.1373067,.025834,.6336734,.1622077,.0826196,21.53793
36055,90381,6356,9870,53336,63206,35674,11844,5631,42782,13438,5913,7108,1594,282,4387,.690214,.7201621,.1614995,.0285714,.6688541,.2220639,.105576,14.22405
36056,17382,1272,1958,10189,12147,6228,1318,548,7721,1549,589,1493,231,41,857,.6737421,.7625127,.1179775,.0209397,.6112474,.1293552,.0537835,34.7382
36057,571697,42184,73551,337699,411250,234507,105550,54091,290945,127574,58588,56438,22024,4497,30852,.7313673,.7673315,.2994385,.0611412,.6944261,.3125564,.1601752,13.20113
36058,14241,994,1440,8364,9804,5130,1111,506,6254,1274,527,1124,163,21,664,.668008,.7805555,.1131944,.0145833,.6133429,.1328312,.0604974,29.99676
36059,26480,1993,2847,14896,17743,9475,2234,975,11539,2587,1053,2064,353,78,1372,.6884094,.7249737,.1239902,.0273973,.6360768,.1499732,.0654538,18.6742
36060,83340,6358,10366,47885,58251,29956,8683,4056,37657,10787,4413,7701,2104,357,4620,.7266436,.7429095,.2029712,.0344395,.6255821,.1813303,.0847029,21.02139
36061,11310,804,1255,6577,7832,4159,849,385,5102,984,430,943,135,45,526,.6542289,.7513945,.1075697,.0358566,.6323552,.1290862,.0585373,32.79509
36062,40076,3025,4388,23996,28384,16039,5011,2204,19384,5733,2370,3345,722,166,2173,.7183471,.7623063,.1645397,.0378304,.6684031,.2088265,.0918486,15.72918
36063,21302,1659,2589,11514,14103,7288,1540,626,9166,1799,671,1878,259,45,1089,.6564195,.7253766,.1000386,.0173812,.6329685,.1337502,.0543686,21.762
36064,31032,2364,3727,17207,20934,10484,2278,1082,13274,2620,1123,2790,342,41,1586,.6708968,.7485914,.0917628,.0110008,.6092869,.132388,.0628814,28.05412
36065,43662,3305,5205,25277,30482,15225,4274,2147,18739,5132,2317,3514,858,170,2217,.6708018,.6751201,.1648415,.0326609,.6023262,.1690865,.0849389,24.35753
36066,22802,1666,2567,13044,15611,6823,2245,1116,8508,2532,1208,1685,287,92,1176,.7058824,.6564083,.1118037,.0358395,.5230758,.1721098,.0855566,40.46166
36067,135856,12440,25229,71301,96530,50591,19914,10792,72037,29707,12441,21446,9793,1649,9759,.7844855,.8500535,.3881644,.0653613,.7095413,.2792948,.1513583,13.51594
36068,38223,2843,4365,22337,26702,14416,3706,1689,17510,4254,1809,3094,548,120,1885,.663032,.7088202,.1255441,.0274914,.6453866,.1659131,.0756145,19.36459
36069,32991,2814,4469,17278,21747,11523,3119,1262,15190,3880,1354,3667,761,92,2076,.7377399,.8205415,.1702842,.0205863,.6669174,.1805186,.0730409,24.71793
36070,131205,9685,16258,76431,92689,50519,16568,7715,62471,19486,8281,11952,2918,566,6494,.6705214,.7351457,.1794809,.0348136,.6609753,.2167707,.1009407,13.70742
36071,65004,4443,7446,38887,46333,22272,7115,3379,27382,8140,3602,5110,1025,223,3026,.6810713,.6862745,.1376578,.029949,.5727364,.182966,.0868928,24.96835
36072,63267,4740,7699,35617,43316,23920,7456,3283,29831,8703,3540,5911,1247,257,3358,.7084388,.7677621,.1619691,.033381,.6715894,.2093382,.0921751,15.21751
36073,84545,5844,9488,49803,59291,27012,8954,3533,33405,10488,3856,6393,1534,323,4122,.7053388,.6737985,.1616779,.034043,.5423769,.1797884,.0709395,30.04682
36074,61901,4799,7985,34483,42468,22893,7308,3167,28964,9181,3439,6071,1873,272,3630,.7564076,.7603006,.2345648,.0340639,.6638923,.2119305,.0918424,17.59996
36075,43089,3286,5241,23720,28961,15132,4424,2015,18946,5117,2157,3814,693,142,2142,.6518564,.7277237,.1322267,.0270941,.6379427,.1865093,.0849494,20.44586
36076,378823,27216,45277,225842,271119,152139,51119,25609,186997,61124,27507,34858,10005,1898,19847,.7292402,.7698832,.2209731,.0419197,.6736524,.2263485,.1133934,13.8235
36077,524472,39213,66736,314078,380814,217314,93768,48563,268645,112636,52626,51331,18868,4063,29844,.7610741,.769165,.282726,.0608817,.6919109,.29855,.1546208,11.11549
36078,241863,17433,28473,143492,171965,97860,31319,14340,119868,37649,15410,22008,6330,1070,12732,.730339,.7729428,.2223159,.0375795,.6819893,.218263,.0999359,13.19107
36079,84614,5985,9978,50696,60674,31591,8365,3946,38913,9977,4219,7322,1612,273,4049,.6765246,.7338144,.1615554,.0273602,.6231458,.1650032,.0778365,18.37596
36080,29536,2144,3445,17081,20526,11782,3629,1753,14286,4078,1872,2504,449,119,1475,.6879664,.7268505,.1303338,.0345428,.6897722,.2124583,.1026286,20.59458
36081,30458,2161,3541,18045,21586,12691,3363,1350,15525,3936,1496,2834,573,146,1446,.6691347,.8003389,.1618187,.0412313,.7032973,.1863674,.074813,17.81563
36082,11584,806,1345,6590,7935,3350,701,363,4257,833,374,907,132,11,529,.6563275,.6743494,.0981413,.0081784,.508346,.1063733,.0550835,46.10638
36083,99276,7870,12863,55405,68268,34732,12614,6260,43209,14485,6702,8477,1871,442,5274,.6701398,.659022,.145456,.0343621,.6268748,.227669,.1129862,16.21613
36084,64266,4851,8098,37092,45190,25319,8517,4240,31952,10432,4568,6633,1915,328,3624,.7470624,.8190911,.2364781,.0405038,.6826,.2296183,.1143104,25.68721
36085,97408,7922,13754,54147,67901,35620,12933,6820,45540,16006,7282,9920,3073,462,5306,.6697804,.7212448,.2234259,.0335902,.6578388,.2388498,.1259534,16.58249
36086,36369,2657,4439,20884,25323,14334,4076,1742,17615,4708,1882,3281,632,140,1858,.6992849,.7391304,.1423744,.0315386,.6863627,.1951733,.0834131,17.11006
36087,107372,11591,23893,54849,78742,41124,17811,10196,62856,29761,11675,21732,11950,1479,9860,.85066,.9095551,.5001465,.061901,.7497675,.3247279,.1858922,13.99039
36088,22651,1683,2720,13143,15863,8775,2292,1148,10695,2586,1194,1920,294,46,1199,.7124183,.7058824,.1080882,.0169118,.6676558,.1743894,.0873469,20.71208
37001,18575,1501,1934,10428,12362,4700,1688,908,5857,1945,923,1157,257,15,1006,.6702198,.598242,.1328852,.0077559,.4507096,.1618719,.0870733,66.11552
37002,7077,542,584,4695,5279,3119,1417,693,3585,1610,747,466,193,54,462,.8523985,.7979452,.3304794,.0924658,.6643237,.3018104,.1476038,27.07434
37003,12748,839,1354,7913,9267,3492,1306,542,4422,1552,566,930,246,24,546,.6507747,.6868538,.1816839,.0177253,.4412991,.1650449,.0684949,57.98288
37004,6806,402,533,4196,4729,2953,1345,606,3385,1491,634,432,146,28,319,.7935323,.8105066,.2739212,.0525328,.7037655,.3205434,.1444233,17.46215
37005,19243,1303,2343,11708,14051,6511,2701,1278,7989,3145,1356,1478,444,78,729,.5594781,.6308152,.1895006,.0332907,.5561154,.230697,.1091561,33.31269
37006,13443,875,1451,8182,9633,4888,1857,928,5871,2134,1027,983,277,99,577,.6594286,.6774638,.1909028,.0682288,.597409,.2269616,.1134197,38.19274
37007,30535,2412,4160,18243,22403,10033,4905,2304,13365,6496,2486,3332,1591,182,1804,.747927,.8009616,.3824519,.04375,.5499644,.2688703,.126295,48.10329
37008,30905,2473,3212,18266,21478,9717,3803,1703,11893,4371,1808,2176,568,105,1734,.7011726,.6774595,.1768369,.0326899,.531972,.208201,.0932333,43.17646
37009,56452,3865,5617,31991,37608,24139,11242,4877,28349,12634,5169,4210,1392,292,2825,.7309185,.7495104,.2478191,.051985,.7545559,.3514113,.1524491,26.28458
37010,43610,3047,4708,26491,31199,15928,6643,2974,19075,7501,3156,3147,858,182,2040,.669511,.6684367,.182243,.0386576,.6012608,.2507644,.1122645,34.92763
37011,30684,2991,4738,16920,21658,9516,5475,3017,13125,7301,3242,3609,1826,225,2143,.7164828,.7617138,.3853947,.0474884,.5624114,.3235815,.1783097,53.87846
37012,17203,1118,1676,10327,12003,4815,1632,744,5968,1977,817,1153,345,73,760,.6797853,.6879475,.2058472,.0435561,.4662535,.1580323,.0720442,61.12847
37013,3648,246,279,2299,2578,1555,630,292,1762,679,311,207,49,19,185,.7520325,.7419355,.1756272,.0681004,.6763811,.2740322,.1270117,20.94826
37014,133173,12717,26060,69270,95330,54616,32181,17779,77136,45614,20308,22520,13433,2529,9967,.7837541,.8641596,.5154643,.0970453,.788451,.4645734,.2566623,20.90517
37015,6041,477,553,3720,4273,1583,586,274,1957,642,281,374,56,7,276,.5786164,.676311,.1012658,.0126582,.4255376,.1575269,.0736559,52.89645
37016,112456,12694,24103,54250,78353,39767,18319,8178,56751,22688,9072,16984,4369,894,5751,.4530487,.7046426,.1812637,.0370908,.7330323,.3376774,.1507465,25.79568
37017,7338,467,672,4650,5322,2578,1046,392,3016,1138,422,438,92,30,328,.7023554,.6517857,.1369048,.0446429,.5544086,.2249462,.0843011,43.91576
37018,15014,987,1514,9627,11141,5439,1870,784,6455,2226,841,1016,356,57,663,.6717325,.67107,.2351387,.0376486,.5649735,.1942454,.0814376,36.81456
37019,59016,4008,5931,34810,40741,20330,6900,3028,24257,7749,3217,3927,849,189,2633,.6569361,.6621143,.1431462,.0318665,.5840276,.1982189,.0869865,34.5738
37020,25995,2564,5299,13955,19254,9225,4865,2482,13853,7559,2910,4628,2694,428,2003,.7812012,.8733723,.5083978,.08077,.6610534,.3486206,.1778574,26.77033
37021,23946,1654,2109,15223,17332,8037,2746,1115,9410,3133,1154,1373,387,39,1013,.6124547,.6510195,.1834993,.0184922,.5279511,.1803849,.0732444,54.21931
37022,5922,394,531,3768,4299,2295,814,395,2696,939,432,401,125,37,309,.784264,.7551789,.2354049,.0696798,.6090764,.2160297,.1048301,36.63907
37023,5596,328,529,3513,4042,2229,930,422,2616,1045,435,387,115,13,231,.7042683,.731569,.2173913,.0245747,.6345004,.264731,.1201252,26.92037
37024,62820,4256,8434,37155,45589,26615,12229,5975,32916,14448,6784,6301,2219,809,2677,.6289943,.7470951,.2631017,.0959213,.7163235,.3291347,.1608128,23.27374
37025,27856,1917,2895,17397,20292,8920,3170,1503,10726,3585,1600,1806,415,97,1194,.6228482,.6238342,.1433506,.033506,.5127321,.1822153,.0863942,31.59607
37026,39490,2899,4562,23063,27625,13393,5424,2715,16548,6291,2867,3155,867,152,1747,.6026216,.6915826,.1900482,.0333187,.5807137,.2351819,.117721,33.55886
37027,6518,342,478,4393,4871,3162,1337,603,3529,1493,666,367,156,63,291,.8508772,.7677824,.3263598,.1317992,.7197815,.3043478,.1372638,22.45297
37028,7028,405,694,4791,5485,2491,993,465,2867,1107,468,376,114,3,283,.6987655,.5417867,.1642651,.0043228,.5199332,.2072636,.097057,35.31242
37029,4519,310,369,2913,3282,1412,561,238,1658,623,251,246,62,13,228,.7354839,.6666667,.1680217,.0352304,.4847237,.192585,.0817027,35.40096
37030,4715,332,479,3049,3528,2031,847,343,2375,960,368,344,113,25,231,.6957831,.7181628,.2359081,.0521921,.6661201,.277796,.1124959,23.4335
37031,11010,665,971,6959,7930,3219,1254,566,3853,1435,575,634,181,9,460,.6917293,.6529351,.1864058,.0092688,.4625665,.1801983,.0813335,57.59431
37032,14338,920,1244,9321,10565,4378,1541,745,5243,1790,783,865,249,38,598,.65,.6953376,.2001608,.0305466,.4696921,.1653256,.079927,50.1786
37033,30356,2571,4576,16209,20785,10811,4932,2201,14442,5826,2326,3631,894,125,1612,.6269934,.7934878,.1953671,.0273164,.6669751,.3042754,.1357888,32.247
37034,8183,531,771,5136,5907,2575,923,387,3045,1039,405,470,116,18,351,.6610169,.6095979,.150454,.0233463,.5013629,.1797118,.0753505,41.73713
37035,10356,843,1213,6166,7379,2942,1251,469,3775,1534,493,833,283,24,624,.7402135,.6867271,.2333059,.0197857,.4771326,.2028868,.0760623,55.49306
37036,49852,3594,5687,31046,36733,21109,10440,4886,25453,12149,5281,4344,1709,395,2569,.7148024,.7638474,.3005099,.0694567,.6799266,.3362752,.1573794,21.37451
37037,14187,1042,1690,8345,10035,5455,2185,947,6705,2525,1009,1250,340,62,604,.5796545,.7396449,.2011834,.0366864,.6536849,.2618334,.1134811,27.25421
37038,12711,893,1247,8178,9425,4473,1732,699,5306,1956,743,833,224,44,592,.6629339,.6680032,.1796311,.0352847,.5469552,.2117877,.0854732,35.11916
37039,9840,1008,1249,5804,7053,3155,1549,593,4130,1884,602,975,335,9,783,.7767857,.7806245,.2682146,.0072058,.5435906,.2668849,.1021709,54.89223
37040,40698,3001,4074,24283,28357,11639,4599,1936,14261,5317,1980,2622,718,44,2019,.6727757,.6435935,.1762396,.0108002,.4793065,.1893918,.0797266,53.4957
37041,26601,1871,2766,15951,18717,9202,3026,1227,11187,3407,1275,1985,381,48,1196,.6392304,.7176428,.137744,.0173536,.5768917,.189706,.0769231,38.79477
37042,26881,2294,3534,15460,18994,9491,4138,1806,12070,5073,1949,2579,935,143,1401,.6107236,.729768,.2645727,.0404641,.6139069,.2676585,.1168176,37.66773
37043,7469,484,698,4643,5341,2378,907,326,2902,967,333,524,60,7,310,.6404959,.7507163,.0859599,.0100287,.5121689,.1953478,.0702132,49.84797
37044,20291,1512,2005,11946,13951,6919,2586,1162,8227,2962,1245,1308,376,83,1093,.7228836,.6523691,.1875312,.0413965,.5791897,.2164741,.0972711,38.96904
37045,36151,2679,3681,20434,24115,9734,3548,1616,11931,3959,1673,2197,411,57,1703,.635685,.5968487,.1116544,.0154849,.4763629,.1736322,.0790839,59.60777
37046,15562,1065,1356,10314,11670,4991,1850,839,5874,2187,885,883,337,46,691,.6488263,.65118,.2485251,.0339233,.4839054,.1793679,.0813457,59.99038
37047,8772,601,912,5360,6272,3255,1204,559,3950,1377,593,695,173,34,389,.6472546,.7620614,.189693,.0372807,.6072761,.2246269,.104291,29.37072
37048,10550,692,981,7001,7982,3650,1308,570,4237,1520,575,587,212,5,469,.6777456,.598369,.216106,.0050968,.5213541,.1868304,.0814169,41.84282
37049,32261,2106,3188,19383,22571,11280,4273,1738,13600,4864,1848,2320,591,110,1339,.6358024,.727729,.1853827,.0345044,.5819533,.2204509,.0896662,37.17331
37050,12147,858,1159,7506,8665,4012,1734,757,4807,1982,815,795,248,58,571,.6655012,.6859362,.2139776,.0500431,.5345057,.2310152,.1008527,41.69338
37051,66939,4966,7647,39931,47578,23603,10644,4792,28944,12316,5091,5341,1672,299,3276,.6596859,.6984438,.2186478,.0391003,.5910946,.2665598,.120007,38.77991
37052,11573,822,1331,7087,8418,4417,1779,627,5330,2048,677,913,269,50,477,.580292,.6859504,.2021037,.0375657,.6232538,.251023,.0884719,28.18533
37053,11486,698,1155,7140,8295,3783,1283,536,4543,1463,564,760,180,28,498,.7134671,.6580086,.1558442,.0242424,.5298319,.1796919,.07507,32.26222
37054,11125,835,1006,6893,7899,3200,1137,489,3832,1282,509,632,145,20,602,.7209581,.6282306,.1441352,.0198807,.4642391,.16495,.0709415,56.42622
37055,568933,39342,78288,334695,412983,246699,130152,64125,306270,155728,70042,59571,25576,5917,25918,.6587871,.7609212,.3266912,.0755799,.737086,.3888675,.1915924,19.20386
37056,39169,3393,5115,23264,28379,12743,5120,2036,16613,6369,2136,3870,1249,100,2582,.7609785,.7565982,.2441838,.0195503,.5477562,.2200825,.0875172,38.80914
37057,39327,2500,3950,23961,27911,15240,6059,2595,18034,6785,2753,2794,726,158,1685,.674,.7073418,.1837975,.04,.6360335,.2528692,.108301,28.22269
37058,32870,3023,4240,19568,23808,11478,4607,1745,14905,5709,1852,3427,1102,107,2388,.7899438,.8082547,.2599057,.0252358,.5865699,.2354354,.0891762,35.43669
37059,15310,1013,1432,9544,10976,5865,2064,931,6924,2295,965,1059,231,34,677,.668312,.7395251,.1613128,.023743,.6145222,.2162615,.0975482,34.9711
37060,62435,7767,20602,29136,49738,21727,13101,7972,41192,26704,9915,19465,13603,1943,6821,.8782027,.9448112,.6602757,.0943112,.7457098,.4496499,.2736134,28.54744
37061,40524,2897,3744,25838,29582,14176,5960,2406,16630,6557,2522,2454,597,116,2000,.6903694,.6554487,.1594551,.0309829,.5486493,.230668,.0931187,44.36765
37062,32598,2711,4810,19440,24250,11423,5783,2969,15265,7587,3122,3842,1804,153,2095,.7727776,.7987526,.375052,.0318087,.5876029,.2974794,.1527263,34.87745
37063,55239,4304,6683,32692,39375,20198,7980,3534,25218,9843,3772,5020,1863,238,3190,.741171,.7511597,.278767,.0356127,.617827,.2440964,.1080998,32.38388
37064,11773,832,1010,7291,8301,3572,1218,605,4261,1378,638,689,160,33,607,.7295673,.6821782,.1584158,.0326733,.4899191,.1670553,.082979,60.74714
37065,4799,305,461,2951,3412,1734,604,308,2095,705,352,361,101,44,244,.8,.7830803,.2190889,.0954447,.5875974,.2046764,.1043714,35.46636
37066,46436,3490,4865,26700,31565,17337,6863,2786,21040,8023,2966,3703,1160,180,2543,.7286533,.7611511,.2384378,.036999,.6493258,.2570412,.1043446,36.40681
37067,27473,1993,2877,16744,19621,9167,3658,1563,11178,4276,1628,2011,618,65,1383,.6939288,.698992,.2148071,.022593,.5474797,.2184663,.0933469,42.07241
37068,30749,2555,3145,17577,20722,8471,3130,1458,10431,3580,1530,1960,450,72,1624,.6356164,.6232114,.1430843,.0228935,.4819366,.1780736,.0829493,58.35368
37069,43419,2762,4794,26885,31679,16445,6372,3153,19913,7239,3374,3468,867,221,1784,.6459088,.7234042,.1808511,.0460993,.6116794,.2370095,.1172773,24.7327
37070,17727,1424,2422,9927,12349,6775,3370,1540,8738,4226,1683,1963,856,143,1077,.7563202,.8104872,.3534269,.0590421,.6824821,.3394782,.1551325,18.62426
37071,12398,953,1207,7528,8735,3942,1739,882,4638,1954,958,696,215,76,559,.5865687,.5766363,.1781276,.062966,.523645,.2310043,.1171626,42.73545
37072,470593,32154,63348,277646,340994,210252,109156,54593,259754,130691,59993,49502,21535,5400,22263,.6923866,.7814296,.3399476,.0852434,.7572665,.3931481,.1966281,18.15882
37073,41801,2802,3952,23396,27348,14802,6125,2815,17417,6817,2922,2615,692,107,1892,.675232,.6616903,.1751012,.0270749,.6326723,.2617969,.1203197,45.37826
37074,48113,2944,4890,30270,35160,22732,12442,7317,26571,14071,7802,3839,1629,485,2210,.7506794,.7850716,.3331288,.099182,.7509745,.411034,.2417245,15.74745
37075,13798,996,1678,8274,9952,5034,1724,684,6253,2006,764,1219,282,80,654,.6566265,.7264601,.1680572,.0476758,.6084119,.2083635,.0826686,28.33391
37076,10923,964,1707,6792,8499,4537,2568,1414,6024,3320,1521,1487,752,107,832,.8630705,.8711189,.4405389,.0626831,.6679918,.3780919,.2081861,26.47801
37077,21172,1476,2770,11940,14710,7968,3107,1301,9871,3636,1435,1903,529,134,888,.601626,.6870036,.1909747,.0483755,.6673367,.2602178,.1089615,20.55085
38001,16134,1041,1481,10129,11610,7055,3237,1312,8037,3572,1395,982,335,83,717,.6887608,.6630655,.2261985,.0560432,.696515,.3195775,.1295291,16.88179
38002,68211,7362,17729,34803,52532,29972,20586,12743,46475,32099,14625,16503,11513,1882,6580,.8937789,.9308478,.649388,.1061538,.8611901,.5915008,.3661466,12.57016
38003,241919,17172,24406,144726,169132,114875,59636,27798,132923,65980,29101,18048,6344,1303,12051,.701782,.7394903,.2599361,.0533885,.7937413,.4120614,.1920733,13.84989
38004,32489,2478,3987,19876,23863,14786,6820,2849,17599,7608,2997,2813,788,148,1559,.6291364,.705543,.1976423,.0371206,.7439123,.3431274,.1433387,16.93206
38005,35646,2461,3522,21000,24522,14553,5316,2090,17012,5934,2207,2459,618,117,1688,.6859,.6981828,.1754685,.0332198,.693,.2531429,.0995238,20.19468
38006,64047,4419,7101,38773,45874,26384,11202,4361,31118,12361,4593,4734,1159,232,2769,.6266124,.6666667,.1632164,.0326715,.6804735,.2889124,.1124752,13.50988
38007,13091,853,1308,7937,9245,5523,2002,747,6411,2232,782,888,230,35,543,.6365768,.6788991,.175841,.0267584,.6958548,.2522364,.0941162,14.45087
38008,16992,984,1480,11211,12691,7636,3216,1262,8748,3522,1337,1112,306,75,613,.6229675,.7513514,.2067568,.0506757,.6811168,.2868611,.112568,12.36649
38009,62142,4147,7079,37081,44160,29027,14237,6155,34577,16128,6451,5550,1891,296,2745,.6619243,.784009,.2671281,.0418138,.7827998,.3839433,.165988,14.47499
38010,93748,6691,10034,54847,64881,37266,14935,5737,44094,16755,5993,6828,1820,256,4500,.6725452,.6804863,.1813833,.0255133,.6794537,.272303,.1046001,15.08561
38011,2057,149,194,1284,1478,1015,528,220,1169,605,238,154,77,18,113,.7583892,.7938144,.3969072,.0927835,.7904984,.4112149,.1713396,11.78474
38012,8210,527,791,4993,5784,3521,1486,560,4127,1643,599,606,157,39,367,.6963947,.7661188,.1984829,.0493047,.7051873,.2976167,.112157,14.33732
38013,8314,595,921,4869,5790,3508,1297,617,4151,1416,659,643,119,42,346,.5815126,.6981542,.1292074,.0456026,.7204765,.2663791,.1267201,17.38931
38014,15835,933,1710,9662,11372,6715,2764,1093,7858,3055,1162,1143,291,69,583,.624866,.668421,.1701754,.0403509,.6949907,.2860691,.1131236,15.94417
38015,132456,9407,14806,80678,95484,59602,28079,12340,71036,32133,12919,11434,4054,579,6393,.6796003,.7722545,.2738079,.0391058,.738764,.3480379,.1529537,16.19604
38016,11599,841,1339,6471,7810,4543,2074,878,5312,2273,930,769,199,52,454,.5398335,.5743092,.1486184,.038835,.7020553,.3205069,.1356823,15.02678
38017,58855,3799,5259,37076,42335,25266,10942,4042,28819,11845,4154,3553,903,112,2563,.6746512,.6756037,.1717056,.0212968,.6814651,.2951235,.1090193,19.89358
38018,59117,4185,6992,34435,41427,25591,10626,4274,30925,12526,4546,5334,1900,272,2698,.6446834,.7628719,.2717391,.0389016,.7431683,.3085814,.1241179,13.5947
38019,7532,496,753,4528,5281,3053,1339,593,3607,1512,622,554,173,29,308,.6209677,.7357238,.2297477,.0385126,.6742491,.2957155,.1309629,12.14463
38020,275226,20227,40961,160411,201372,124465,68075,32771,158257,84922,35706,33792,16847,2935,14568,.7202255,.8249798,.4112937,.0716535,.7759131,.4243786,.204294,12.98424
38021,35264,2142,3502,23469,26971,16986,7897,3368,19317,8605,3480,2331,708,112,1136,.5303455,.6656197,.2021702,.0319817,.7237633,.3364864,.1435085,19.53449
38022,89495,6455,10398,52501,62899,36510,14866,5548,43922,17108,5849,7412,2242,301,4255,.6591789,.7128294,.2156184,.0289479,.6954153,.2831565,.1056742,16.49702
38023,26896,2057,2881,15280,18161,10341,4826,1834,12426,5448,1886,2085,622,52,1510,.7340788,.723707,.2158973,.0180493,.676767,.3158377,.1200262,24.95812
38024,204692,14812,25808,120890,146698,88856,43827,20239,107163,50555,21453,18307,6728,1214,9656,.6519039,.7093537,.2606944,.0470397,.7350153,.3625362,.1674167,19.45235
38025,7519,535,836,4275,5111,3069,1296,501,3637,1492,543,568,196,42,365,.682243,.6794258,.2344498,.0502392,.7178947,.3031579,.117193,15.82899
38026,562640,35711,76163,353666,429829,270209,146735,70105,329709,172247,75431,59500,25512,5326,23088,.6465235,.7812192,.3349658,.069929,.7640231,.4148971,.1982238,13.77607
38027,45203,3348,5944,26600,32544,19603,10676,5327,24288,12939,5731,4685,2263,404,2312,.6905615,.7881898,.38072,.0679677,.7369549,.4013534,.2002632,18.31388
38028,2172,126,175,1337,1512,1008,463,191,1145,517,206,137,54,15,94,.7460318,.7828571,.3085714,.0857143,.7539267,.3462977,.1428571,9.859719
38029,21164,1218,2012,13672,15684,9328,3619,1531,10737,3896,1564,1409,277,33,756,.6206896,.7002982,.137674,.0164016,.6822703,.2647016,.1119807,15.34879
38030,58861,4088,6875,34360,41235,24508,10735,4175,29200,12190,4377,4692,1455,202,2694,.6590019,.6824727,.2116364,.0293818,.7132713,.3124273,.1215076,17.149
38031,23921,1806,3135,13718,16853,10295,4865,2125,12922,5966,2259,2627,1101,134,1408,.7796234,.8379585,.3511962,.0427432,.7504739,.3546435,.154906,19.20009
38032,7273,436,632,4608,5240,3433,1394,607,3929,1520,625,496,126,18,343,.7866973,.7848101,.1993671,.028481,.7450087,.3025174,.1317274,16.63712
38033,21732,1350,2132,13376,15508,10060,4190,1821,11544,4574,1908,1484,384,87,833,.6170371,.6960601,.1801126,.0408068,.7520933,.3132476,.1361393,14.22558
38034,245808,16319,29990,144438,174428,122840,73758,37380,146925,84435,39951,24085,10677,2571,11188,.6855812,.8031011,.3560187,.0857286,.8504687,.5106551,.2587962,11.81863
38035,1513,111,115,977,1092,657,190,67,749,216,74,92,26,7,70,.6306306,.8,.226087,.0608696,.6724668,.1944729,.0685773,12.59338
38036,55332,4160,7004,31884,38888,22948,10730,4775,28278,12616,5011,5330,1886,236,2874,.6908654,.7609937,.2692747,.033695,.719734,.3365324,.1497616,22.80075
39001,68292,5646,9504,39296,48800,23252,7707,4508,30720,10165,4886,7468,2458,378,3843,.6806589,.7857744,.258628,.0397727,.5917141,.1961268,.1147191,19.85099
39002,1450085,102065,183167,920764,1103931,635653,263569,151927,791678,329818,169465,156025,66249,17538,76292,.7474844,.8518183,.3616863,.0957487,.6903539,.2862503,.165001,13.92798
39003,77768,5488,8932,47711,56643,28006,6617,3215,35140,7914,3498,7134,1297,283,3767,.6864067,.7987013,.1452082,.0316838,.5869925,.1386892,.0673849,23.52132
39004,204441,14895,24750,125346,150096,81211,25044,11814,101257,31159,12761,20046,6115,947,10642,.7144679,.8099394,.2470707,.0382626,.6478946,.199799,.0942511,13.14478
39005,46784,3178,5165,27860,33025,16158,3761,1820,20226,4428,1941,4068,667,121,2029,.6384519,.7876089,.1291384,.0234269,.5799713,.1349964,.0653266,29.5445
39006,312509,22022,37047,196788,233835,115197,39591,22379,144638,48719,24126,29441,9128,1747,15043,.6830896,.7946932,.2463897,.0471563,.5853863,.201186,.1137214,13.04932
39007,136621,9724,15674,83346,99020,54467,14300,6761,67559,17211,7400,13092,2911,639,6740,.6931304,.8352686,.1857216,.0407682,.6535047,.1715739,.0811197,20.88317
39008,62919,4833,6986,36242,43228,23504,6785,3210,28810,8069,3519,5306,1284,309,3278,.6782537,.759519,.1837962,.0442313,.6485294,.1872137,.0885713,23.30445
39009,479211,36609,58259,277902,336161,207678,91333,51734,255884,107829,55429,48206,16496,3695,26768,.7311863,.8274429,.2831494,.0634237,.7473066,.3286518,.1861591,8.078632
39010,147912,11684,19852,85376,105228,58964,20598,9973,75604,26713,10865,16640,6115,892,8705,.7450359,.8382027,.3080294,.0449325,.6906391,.2412622,.1168127,15.69088
39011,183263,12992,23082,110535,133617,67497,18451,9507,86734,23935,10520,19237,5484,1013,9194,.7076663,.83342,.2375877,.043887,.6106392,.1669245,.086009,25.62562
39012,6674,420,686,4167,4853,2686,755,303,3216,972,360,530,217,57,272,.6476191,.7725947,.3163265,.0830904,.6445884,.1811855,.0727142,14.59933
39013,53285,3388,5440,34243,39683,19665,5236,2503,23872,6213,2716,4207,977,213,2297,.6779811,.7733456,.1795956,.0391544,.5742779,.1529072,.0730952,21.64679
39014,112760,12822,34293,54047,88340,40947,21103,14837,73449,44524,17786,32502,23421,2949,11145,.8692092,.9477736,.6829674,.0859942,.7576184,.3904565,.2745203,21.66649
39015,316660,24771,39874,186663,226537,142665,76102,49066,175218,89459,52188,32553,13357,3122,18496,.7466796,.8163967,.3349802,.0782966,.7642918,.4076973,.2628587,12.70798
39016,43362,4495,8053,23443,31496,14928,4703,2578,21915,7929,2937,6987,3226,359,3521,.7833148,.867627,.4005961,.0445797,.6367786,.2006143,.1099689,24.21089
39017,83578,6039,9363,49374,58737,29435,7699,3752,36873,9013,4136,7438,1314,384,3836,.6352045,.7944035,.1403396,.0410125,.596164,.1559323,.0759914,26.95484
39018,38971,3359,5952,22636,28588,14411,4095,2104,19407,5951,2253,4996,1856,149,2583,.7689788,.8393817,.311828,.0250336,.6366407,.1809065,.0929493,20.17158
39019,61967,5574,9875,36506,46381,23180,6996,3715,31719,10948,4070,8539,3952,355,4291,.7698242,.8647088,.4002025,.0359494,.6349641,.1916397,.1017641,21.06879
39020,88869,6695,10732,52169,62901,34898,11039,5462,43516,13723,5974,8618,2684,512,5141,.7678865,.803019,.2500932,.0477078,.6689413,.2116008,.1046982,21.33307
39021,178541,14399,25662,107034,132696,77985,34203,20339,99536,43352,22274,21551,9149,1935,10923,.7585943,.839802,.3565194,.0754033,.7286003,.3195527,.1900237,12.68292
39022,232317,15309,27863,143948,171811,100619,37438,20588,122731,44975,22906,22112,7537,2318,10319,.6740479,.7935972,.2705021,.0831928,.6989955,.26008,.1430239,15.92946
39023,555007,43320,73452,340409,413861,246129,109274,64283,309267,135803,70513,63138,26529,6230,32775,.7565789,.8595818,.3611746,.0848173,.723039,.321008,.1888405,8.879473
39024,38338,2847,4337,22436,26773,14497,3875,1983,18145,4586,2190,3648,711,207,1926,.6765016,.8411344,.1639382,.0477288,.646149,.1727135,.0883847,13.91008
39025,279780,22451,39070,159736,198806,111720,39773,21143,143327,50889,23252,31607,11116,2109,16836,.7498998,.8089839,.284515,.05398,.699404,.2489921,.1323621,16.23413
39026,159417,10681,17499,97695,115194,56483,14009,7028,70482,17048,7760,13999,3039,732,7011,.6563992,.7999886,.1736671,.041831,.5781565,.1433953,.0719382,33.30604
39027,5072,382,490,3231,3721,1909,417,188,2278,483,206,369,66,18,277,.7251309,.7530612,.1346939,.0367347,.5908387,.1290622,.0581863,23.31584
39028,113629,8390,13057,68375,81432,40101,12727,7032,50381,14964,7578,10280,2237,546,5728,.6827175,.7873172,.1713257,.0418167,.5864863,.1861353,.1028446,21.48999
39029,12842,855,1400,7492,8892,3889,988,544,4871,1090,564,982,102,20,589,.6888889,.7014286,.0728571,.0142857,.519087,.131874,.0726108,36.55345
39030,40476,2821,4594,23999,28593,13293,4023,2276,16961,5115,2516,3668,1092,240,2001,.7093229,.7984328,.2377014,.0522421,.5538981,.167632,.0948373,29.62049
39031,42253,3230,5469,24885,30354,15314,4095,2144,19906,5466,2313,4592,1371,169,2343,.725387,.8396416,.2506857,.0309014,.6153908,.164557,.0861563,33.45181
39032,92281,9174,18177,49635,67812,32028,9937,5556,48085,18122,6414,16057,8185,858,7047,.7681491,.8833691,.4502943,.0472025,.6452705,.2002015,.1119371,26.22773
39033,48303,3422,5613,29018,34631,18094,4900,2424,22677,5798,2693,4583,898,269,2381,.695792,.8164974,.1599858,.0479245,.623544,.1688607,.0835344,26.62572
39034,19188,1298,2100,11464,13564,6338,1461,768,7911,1708,824,1573,247,56,771,.5939907,.7490476,.117619,.0266667,.5528612,.1274424,.0669923,30.26498
39035,227908,16195,27158,145319,172477,92693,32936,15541,116134,42582,17356,23441,9646,1815,12158,.7507255,.8631343,.3551808,.0668311,.6378588,.2266462,.106944,20.2793
39036,362346,27708,48398,211371,259769,126012,47371,27457,162331,59268,29741,36319,11897,2284,16962,.6121697,.7504236,.2458159,.047192,.5961651,.224113,.1298996,15.56422
39037,107150,7777,13574,65815,79389,41583,13115,6569,52573,16467,7150,10990,3352,581,5597,.7196863,.8096361,.2469427,.0428024,.6318164,.1992707,.0998101,15.85352
39038,108582,7692,12509,66070,78579,39393,11083,6204,49281,13438,6800,9888,2355,596,5074,.6596464,.7904708,.1882644,.0476457,.5962313,.1677463,.0939004,14.98705
39039,272349,18789,33382,171976,205358,111057,44962,24391,138969,55526,26973,27912,10564,2582,13517,.7194103,.8361393,.316458,.0773471,.6457703,.2614435,.1418279,11.44468
39040,343079,23046,37450,222071,259521,135990,42749,20536,167117,54011,22955,31127,11262,2419,16732,.7260262,.8311616,.300721,.0645928,.6123717,.1925015,.0924749,23.24339
39041,118416,8963,14709,70716,85425,46407,15610,7317,58248,19621,8075,11841,4011,758,6276,.700212,.8050174,.2726902,.0515331,.6562447,.2207421,.1034702,19.09952
39042,50635,3614,5566,30537,36103,19849,5884,2811,24407,7075,3048,4558,1191,237,2590,.7166575,.8189005,.2139777,.0425799,.6499984,.1926843,.0920523,17.52171
39043,128299,10003,16888,77094,93982,51491,16479,8997,65499,21371,9663,14008,4892,666,7357,.7354794,.8294647,.2896731,.0394363,.667899,.213752,.1167017,15.36965
39044,46908,3114,4779,28439,33218,16374,3924,1941,20039,4672,2131,3665,748,190,1995,.6406551,.7668968,.1565181,.0397573,.5757586,.1379795,.0682513,24.09106
39045,69409,5262,8622,42902,51524,29109,11303,6012,36340,14126,6535,7231,2823,523,4120,.7829723,.8386685,.3274182,.0606588,.6784998,.2634609,.1401333,20.14857
39046,643621,47271,76424,403932,480356,306208,158990,100431,371514,188152,108745,65306,29162,8314,36740,.7772207,.8545222,.3815817,.1087878,.7580682,.3936059,.2486334,6.8612
39047,16675,1179,1875,10434,12309,6293,2409,1439,7818,2754,1523,1525,345,84,718,.6089907,.8133333,.184,.0448,.6031244,.2308798,.1379145,18.67263
39048,225418,16770,28892,139478,168370,86190,31847,17178,110587,41934,18679,24397,10087,1501,12262,.7311866,.8444206,.3491278,.0519521,.6179469,.2283299,.1231592,14.07095
39049,100381,6588,10106,64171,74277,36971,8489,4309,44869,10106,4677,7898,1617,368,4291,.6513358,.781516,.160004,.036414,.5761325,.1322872,.0671487,25.56655
39050,35718,2392,3945,20982,24927,12828,3161,1516,15667,3563,1607,2839,402,91,1538,.6429766,.7196451,.1019011,.0230672,.6113812,.1506529,.0722524,24.61461
39051,1688210,122091,224264,1026429,1250693,556965,208865,113721,722806,277863,131864,165841,68998,18143,82036,.6719251,.7394901,.3076642,.0809002,.542624,.203487,.1107929,18.74139
39052,18271,1056,1474,12387,13861,8052,3049,1455,9168,3447,1548,1116,398,93,790,.7481061,.7571235,.2700136,.0630936,.6500363,.2461452,.1174619,22.13667
39053,17726,1262,1813,10317,12130,6353,1982,864,7751,2309,924,1398,327,60,879,.6965135,.7710976,.180364,.0330943,.6157798,.1921101,.0837453,27.61363
39054,160630,10085,15930,104666,120596,58897,13539,6428,71447,16801,7017,12550,3262,589,6879,.6821021,.7878217,.2047709,.0369743,.5627138,.1293543,.0614144,24.02407
39055,33584,2891,5059,19267,24326,11398,3475,1863,15437,4875,1954,4039,1400,91,1927,.6665514,.7983791,.2767345,.0179877,.5915815,.1803602,.0966938,24.42988
39056,81243,5389,9130,49297,58427,28580,6858,3642,35931,8118,3975,7351,1260,333,3531,.6552236,.8051479,.1380066,.0364732,.5797513,.139116,.0738787,32.74802
39057,6349,681,783,3799,4582,2318,604,305,2873,697,325,555,93,20,312,.4581498,.7088122,.1187739,.0255428,.6101606,.1589892,.0802843,27.35683
39058,37876,2703,3877,22550,26427,14690,4286,1968,17649,4891,2078,2959,605,110,1928,.7132815,.763219,.1560485,.0283725,.6514412,.1900665,.0872727,23.19606
39059,40973,3579,5692,23074,28766,14742,4733,2379,19375,6610,2563,4633,1877,184,2739,.7652976,.8139494,.3297611,.0323261,.6389009,.2051226,.1031031,22.28914
39060,32870,3104,6026,18573,24599,12163,4445,2652,17282,7155,2920,5119,2710,268,2433,.7838273,.8494856,.4497179,.0444739,.6548753,.2393259,.1427879,20.49115
39061,64444,4494,7121,39079,46200,25374,7266,3599,30882,8392,3838,5508,1126,239,2968,.6604362,.7734869,.1581239,.0335627,.6493002,.1859311,.0920955,18.51324
39062,47449,3203,5008,29006,34014,19385,5684,2649,23481,6646,2887,4096,962,238,2135,.6665626,.8178914,.1920927,.047524,.66831,.1959595,.0913259,14.81084
39063,217074,14768,25586,135253,160839,84355,27486,14501,105774,34462,15767,21419,6976,1266,10422,.7057151,.8371375,.2726491,.0494802,.623683,.2032191,.1072139,18.2512
39064,35237,2378,3450,21748,25198,13510,4262,1913,16254,4824,2043,2744,562,130,1614,.6787216,.7953623,.1628986,.0376812,.6212065,.195972,.0879621,24.5146
39065,392294,26610,43409,244605,288014,167689,55796,30324,204228,66801,32703,36539,11005,2379,19420,.7298008,.8417379,.2535188,.0548043,.6855502,.2281065,.1239713,16.96769
39066,26433,1779,2741,15198,17939,10426,3379,1626,12626,3935,1754,2200,556,128,1276,.7172569,.8026268,.2028457,.0466983,.6860113,.2223319,.1069878,29.91781
39067,312963,22288,37008,189918,226926,117355,39723,21414,146586,46546,23268,29231,6823,1854,14132,.6340632,.7898563,.1843655,.0500973,.6179246,.2091587,.1127539,14.884
40001,46942,4144,6354,28451,34805,17532,9842,5872,22567,12164,6214,5035,2322,342,3264,.7876448,.7924142,.3654391,.0538244,.6162174,.3459281,.2063899,12.02204
40002,154163,11287,17860,93958,111818,62800,27801,13933,76473,32736,15029,13673,4935,1096,8091,.7168424,.7655655,.2763158,.0613662,.6683837,.2958875,.1482897,12.021
40003,81383,5657,11002,48269,59271,34773,18533,11361,43709,22294,12450,8936,3761,1089,3937,.6959519,.812216,.3418469,.098982,.7204003,.3839524,.2353685,24.75652
40004,571349,43141,78025,351877,429902,197342,85680,45376,257303,113003,50205,59961,27323,4829,30368,.7039244,.7684845,.3501826,.0618904,.5608267,.2434942,.1289542,16.78977
40005,93317,8318,15500,52688,68188,38847,20950,12226,52100,28165,13365,13253,7215,1139,6584,.7915365,.8550323,.4654839,.0734839,.7373026,.3976237,.2320452,15.10869
41001,22627,1710,2924,13020,15944,5527,2365,1127,7491,3174,1209,1964,809,82,1261,.7374269,.6716827,.2766758,.0280438,.4245008,.1816436,.0865591,44.38631
41002,105625,7748,12771,60604,73375,33286,15605,8064,42179,18501,8725,8893,2896,661,5232,.675271,.6963433,.2267638,.0517579,.5492377,.2574913,.1330605,34.46734
41003,10700,816,1162,5886,7048,2541,1218,637,3290,1442,679,749,224,42,543,.6654412,.6445783,.1927711,.0361446,.4317023,.2069317,.1082229,66.0875
41004,133235,9610,15833,78815,94648,37265,17256,7972,47584,20907,8567,10319,3651,595,6419,.66795,.65174,.2305943,.0375797,.4728161,.2189431,.1011483,35.18533
41005,18118,1855,2762,9497,12259,4101,1978,868,6098,3008,939,1997,1030,71,1519,.8188679,.7230268,.3729182,.025706,.4318206,.2082763,.0913973,63.07226
41006,19868,1443,2301,10877,13178,4925,2128,1006,6480,2687,1138,1555,559,132,1004,.6957727,.6757931,.2429378,.0573664,.4527903,.1956422,.0924887,53.20109
41007,65364,7875,15352,31838,47190,22935,12605,6985,34879,15241,7513,11944,2636,528,2729,.3465397,.7780094,.171704,.0343929,.7203656,.3959106,.2193919,49.199
41008,94727,7302,13530,47479,61009,29159,11038,4223,38836,13736,4717,9677,2698,494,5062,.6932347,.7152254,.1994087,.0365115,.6141452,.2324817,.0889446,55.04887
41009,12206,1016,1539,6767,8306,3217,1400,675,4192,1708,740,975,308,65,707,.6958662,.6335283,.20013,.0422352,.4753953,.2068864,.0997488,70.61818
41010,276974,24842,52309,147099,199408,93614,49835,25502,133859,65429,28723,40245,15594,3221,16662,.670719,.7693705,.2981131,.0615764,.6364014,.3387854,.1733662,40.23685
41011,40983,2945,4746,23601,28347,10153,4271,2112,13261,5196,2279,3108,925,167,1864,.6329372,.6548672,.194901,.0351875,.4301936,.1809669,.0894877,43.96378
41012,30148,2160,3285,17353,20638,7222,3085,1489,9509,3739,1584,2287,654,95,1477,.6837963,.6961948,.1990868,.0289193,.4161817,.1777791,.0858065,46.7532
41013,38161,2915,4379,21523,25902,8743,3590,1638,11312,4339,1796,2569,749,158,2030,.696398,.5866636,.1710436,.0360813,.4062166,.1667983,.0761046,56.72046
41014,27464,2432,3503,14785,18288,6172,2633,1285,8397,3176,1386,2225,543,101,1788,.7351974,.6351699,.15501,.0288324,.4174501,.1780859,.0869124,71.08579
41015,31776,2644,3563,17840,21403,8051,3215,1577,10421,3937,1778,2370,722,201,1851,.7000756,.6651698,.2026382,.0564131,.4512892,.180213,.0883969,62.05207
41016,62717,4951,7227,34557,41784,16237,7416,3635,21207,8987,3963,4970,1571,328,3500,.7069279,.6876989,.2173793,.0453854,.4698614,.214602,.1051885,53.39907
41017,31083,2522,3652,16040,19692,6303,2760,1273,8338,3257,1393,2035,497,120,1900,.7533703,.5572289,.1360898,.0328587,.3929551,.1720698,.0793641,61.48956
41018,58761,4818,7158,31406,38564,20192,9371,4320,25141,10998,4676,4949,1627,356,3580,.7430469,.6913943,.2272981,.0497346,.6429344,.2983825,.1375533,55.27776
41019,17528,1321,2095,9746,11841,4022,1864,958,5363,2274,1045,1341,410,87,823,.6230128,.6400955,.1957041,.0415274,.4126821,.191258,.0982967,62.94371
41020,20700,1670,2521,11441,13962,4958,2203,1070,6565,2547,1187,1607,344,117,1149,.6880239,.6374454,.1364538,.0464102,.4333537,.1925531,.0935233,62.7254
41021,110163,8500,13432,60997,74429,31432,15007,7347,40686,18707,8143,9254,3700,796,6131,.7212941,.6889517,.2754616,.0592615,.515304,.2460285,.1204485,51.62456
41022,42461,3420,4957,22774,27731,11521,5389,2529,14799,6515,2748,3278,1126,219,2646,.7736842,.6612871,.2271535,.0441799,.5058839,.2366295,.1110477,57.56493
41023,287913,22295,39396,167574,206970,94013,49677,25961,122736,62295,28656,28723,12618,2695,15711,.7046872,.7290842,.3202863,.068408,.5610238,.2964481,.1549226,29.69934
41024,57847,4273,6947,34098,41045,16779,8811,4711,21718,10956,5167,4939,2145,456,3134,.7334425,.7109544,.3087664,.0656398,.4920816,.2584023,.1381606,36.14108
41025,18159,1373,2025,10022,12047,4283,1560,738,5514,1936,827,1231,376,89,1046,.7618354,.6079012,.185679,.0439506,.4273598,.1556576,.073638,64.40496
41026,101419,7739,13635,57088,70723,33397,16141,7143,43473,19290,7733,10076,3149,590,5323,.687815,.7389806,.2309498,.043271,.5850091,.2827389,.1251226,51.80262
41027,14504,1259,1758,7618,9376,3518,1179,595,4625,1418,636,1107,239,41,977,.7760127,.6296929,.1359499,.023322,.461801,.154765,.0781045,66.56133
41028,39015,3027,4528,22265,26793,11480,5014,2696,14573,5876,2951,3093,862,255,2033,.6716221,.6830831,.190371,.0563163,.5156075,.2251965,.1210869,50.33019
41029,53361,3811,6452,30438,36890,14073,5362,2494,18309,6562,2627,4236,1200,133,2467,.6473367,.6565406,.1859888,.0206138,.4623497,.1761614,.0819371,37.78588
41030,52214,4113,6392,30656,37048,12369,5402,2667,16183,7073,2876,3814,1671,209,2894,.7036226,.5966834,.2614205,.0326971,.4034773,.1762135,.0869977,39.91501
41031,18929,1789,2507,9784,12291,3898,1562,807,5610,1956,887,1712,394,80,1284,.7177194,.6828879,.15716,.0319107,.3984056,.1596484,.0824816,73.31989
41032,140353,10288,17388,79511,96899,51070,27234,13842,63957,32507,15272,12887,5273,1430,7233,.7030521,.7411433,.3032551,.0822406,.6423011,.3425187,.1740891,33.39743
41033,7797,620,953,4241,5194,1785,774,395,2439,1017,438,654,243,43,477,.7693548,.6862539,.2549843,.0451207,.4208913,.1825041,.0931384,61.52948
41034,34179,2627,4057,18564,22621,8100,3258,1490,10668,4046,1612,2568,788,122,2014,.766654,.63298,.1942322,.0300715,.4363284,.175501,.0802629,64.48835
41035,31634,2526,3648,16901,20549,6714,2986,1436,8965,3555,1559,2251,569,123,1763,.6979414,.6170504,.1559759,.0337171,.3972546,.1766759,.0849654,63.82979
41036,31242,2350,3911,18834,22745,8624,4240,2265,11397,5344,2457,2773,1104,192,1594,.6782979,.7090258,.2822807,.0490923,.4578953,.2251248,.1202612,46.71924
41037,48611,3455,5601,28765,34366,13237,5248,2670,17062,6368,2878,3825,1120,208,2187,.6329957,.6829138,.1999643,.0371362,.4601773,.1824439,.0928211,40.21482
41038,82276,7742,12106,43903,56009,21643,10863,5573,30689,15302,6036,9046,4439,463,6248,.8070266,.7472328,.3666777,.0382455,.4929731,.2474318,.1269389,62.40087
41039,79292,7919,16014,42513,58527,21467,10570,5706,34865,18584,6908,13398,8014,1202,6332,.7995959,.8366429,.5004371,.0750593,.5049514,.2486298,.1342178,29.7684
41040,269735,27546,54603,144265,198868,97252,60595,33225,140986,83307,38091,43734,22712,4866,17741,.6440499,.800945,.4159479,.089116,.6741205,.4200256,.2303053,37.53982
41041,16150,1157,1793,9353,11146,3964,1500,701,5102,1778,737,1138,278,36,859,.7424374,.6346905,.1550474,.0200781,.4238212,.1603764,.0749492,52.87775
41042,201861,14828,24499,119515,144014,59216,29827,14936,75501,36412,16218,16285,6585,1282,10475,.7064338,.664721,.2687865,.0523287,.4954692,.249567,.1249718,36.19995
41043,88243,7666,13656,45304,58960,24658,11366,5188,34642,14449,5591,9984,3083,403,5184,.6762327,.7311072,.2257616,.0295108,.5442786,.2508829,.1145153,52.5384
41044,30751,2264,3661,18278,21939,7566,3113,1470,9789,3831,1595,2223,718,125,1458,.643993,.6072112,.1961213,.0341437,.4139403,.170314,.0804246,39.39053
41045,38226,3121,4521,19887,24408,8659,3391,1748,11890,4260,1934,3231,869,186,2269,.7270105,.7146649,.1922141,.0411413,.4354101,.1705134,.0878966,72.45921
41046,106720,8730,14452,59700,74152,31387,16027,7880,41640,20857,8651,10253,4830,771,5912,.677205,.709452,.3342098,.053349,.5257454,.268459,.1319933,38.98336
42001,3628,320,289,2195,2484,1306,576,190,1525,661,210,219,85,20,264,.825,.7577854,.2941177,.0692042,.5949886,.2624146,.0865604,49.80004
42002,19195,1364,2306,11654,13960,7849,3593,1508,9607,4126,1583,1758,533,75,991,.7265396,.7623591,.2311362,.0325239,.6735027,.3083062,.1293976,26.24583
42003,3044,241,324,1602,1926,966,383,150,1190,460,169,224,77,19,133,.5518672,.691358,.2376543,.058642,.6029962,.2390762,.093633,42.30203
42004,8059,777,1136,4793,5929,2677,1327,528,3716,1784,563,1039,457,35,664,.8545688,.9146127,.4022887,.0308099,.5585228,.2768621,.1101606,46.3819
42005,24332,3072,7046,11649,18695,8686,5079,2830,15431,9444,3317,6745,4365,487,2715,.8837891,.9572808,.6195004,.0691172,.7456434,.4360031,.2429393,31.55879
42006,36962,3194,5815,20659,26474,14840,6979,3001,19879,9535,3398,5039,2556,397,2394,.7495304,.866552,.4395529,.0682717,.718331,.3378189,.1452636,24.77965
42007,5245,379,486,3115,3601,1982,853,351,2371,1007,407,389,154,56,274,.7229552,.8004115,.3168724,.1152263,.6362761,.2738363,.1126806,26.95442
42008,1795,158,237,745,982,451,172,54,575,194,54,124,22,0,52,.3291139,.5232068,.092827,0,.6053692,.2308725,.0724832,61.27049
42009,8372,579,864,4937,5801,3240,1531,611,3903,1813,637,663,282,26,401,.6925734,.7673611,.3263889,.0300926,.656269,.3101074,.1237594,19.47213
42010,2243,166,180,1449,1629,790,307,133,942,357,138,152,50,5,135,.813253,.8444445,.2777778,.0277778,.5452036,.2118703,.0917874,30.3132
42011,9680,679,925,5499,6424,3114,1303,524,3786,1520,565,672,217,41,459,.6759941,.7264865,.2345946,.0443243,.5662848,.2369522,.09529,46.34583
42012,4894,308,391,3149,3540,1891,762,260,2187,867,272,296,105,12,235,.762987,.7570332,.2685422,.0306905,.6005081,.2419816,.0825659,42.72351
42013,13689,1994,4685,6087,10772,4822,3042,1862,9340,6128,2332,4518,3086,470,1889,.947342,.9643543,.658698,.1003202,.7921801,.4997536,.3058978,28.2046
42014,20885,1666,2762,11896,14658,8160,3354,1392,10426,4031,1485,2266,677,93,1130,.6782713,.82042,.2451122,.0336713,.6859449,.2819435,.1170141,27.07527
42015,5196,493,643,2483,3126,1270,489,196,1656,624,241,386,135,45,268,.5436106,.600311,.2099533,.0699845,.5114781,.1969392,.0789368,52.05851
42016,6000,470,575,3613,4188,2461,1233,484,2834,1325,516,373,92,32,235,.5,.6486956,.16,.0556522,.6811514,.3412676,.1339607,25.98739
42017,17820,1483,2580,10198,12778,6947,3211,1474,9054,3959,1598,2107,748,124,1104,.744437,.8166667,.2899225,.048062,.681212,.3148656,.1445381,25.3574
42018,8133,528,687,5095,5782,2928,1274,496,3426,1425,530,498,151,34,399,.7556818,.7248908,.2197962,.0494905,.574681,.2500491,.0973503,42.42801
42019,5289,401,512,3220,3732,1799,673,264,2178,754,284,379,81,20,306,.7630923,.7402344,.1582031,.0390625,.5586957,.2090062,.0819876,35.5816
42020,5366,443,663,2522,3185,1403,552,250,1808,656,276,405,104,26,242,.5462754,.6108598,.1568628,.0392157,.5563045,.2188739,.0991277,44.51307
42021,4181,310,418,2457,2875,1175,522,194,1485,628,219,310,106,25,227,.7322581,.7416268,.2535885,.0598086,.4782255,.2124542,.0789581,44.02631
42022,5159,377,402,3179,3581,1724,789,310,2002,902,332,278,113,22,255,.6763926,.6915423,.2810945,.0547264,.5423089,.2481913,.0975149,39.1468
42023,8439,519,772,5352,6124,3497,1683,717,4079,1887,745,582,204,28,301,.5799615,.753886,.2642487,.0362694,.6534006,.3144619,.1339686,18.73695
42024,3327,270,272,2073,2345,1261,524,182,1453,588,197,192,64,15,188,.6962963,.7058824,.2352941,.0551471,.6082972,.2527738,.0877955,44.65807
42025,9013,645,853,5266,6119,3304,1254,516,3989,1436,587,685,182,71,456,.7069768,.8030481,.2133646,.0832356,.6274212,.2381314,.0979871,38.78812
42026,6015,412,573,3712,4285,2216,922,343,2684,1037,374,468,115,31,267,.6480582,.8167539,.2006981,.0541012,.5969828,.2483836,.092403,36.61882
42027,2794,182,313,1519,1832,1072,409,132,1309,484,150,237,75,18,145,.7967033,.7571885,.2396166,.057508,.7057275,.2692561,.0868993,25.84367
42028,5261,311,404,3309,3713,1896,753,245,2207,849,270,311,96,25,236,.7588425,.769802,.2376238,.0618812,.5729828,.2275612,.0740405,44.5456
42029,4948,348,411,3082,3493,1979,863,310,2308,970,325,329,107,15,292,.8390805,.8004866,.2603406,.0364963,.6421155,.280013,.100584,38.58633
42030,3415,253,315,1952,2267,1155,357,127,1378,435,141,223,78,14,178,.7035573,.7079365,.247619,.0444444,.5917008,.1828893,.0650615,52.58098
42031,1700,143,191,986,1177,630,305,116,757,359,135,127,54,19,118,.8251748,.6649215,.2827225,.0994764,.6389452,.3093306,.1176471,22.35587
42032,14220,908,1419,8194,9613,6512,3819,2139,7594,4237,2263,1082,418,124,701,.7720264,.7625088,.2945736,.0873855,.7947279,.4660727,.2610447,15.52687
42033,9350,623,699,6069,6768,3080,1440,576,3624,1666,610,544,226,34,482,.7736757,.7782546,.323319,.0486409,.5074971,.2372714,.0949086,45.42561
42034,2069,161,172,1263,1435,848,377,164,973,419,170,125,42,6,123,.7639751,.7267442,.244186,.0348837,.6714172,.2984957,.1298496,40.24059
42035,3437,260,340,1748,2088,1023,420,183,1248,469,195,225,49,12,178,.6846154,.6617647,.1441177,.0352941,.5852402,.2402746,.1046911,26.41509
42036,2929,196,232,1852,2084,1129,466,169,1288,495,178,159,29,9,152,.7755102,.6853448,.125,.0387931,.6096112,.2516199,.0912527,46.44214
42037,1463,84,124,898,1022,595,246,102,697,286,105,102,40,3,57,.6785714,.8225806,.3225806,.0241935,.6625835,.2739421,.1135857,39.14223
42038,6679,431,572,4336,4908,2701,1102,416,3150,1267,460,449,165,44,322,.7470998,.784965,.2884615,.0769231,.6229243,.2541513,.095941,34.52944
42039,10724,882,1719,6210,7929,4157,1840,828,5656,2481,888,1499,641,60,717,.8129252,.8720186,.3728912,.034904,.6694042,.2962963,.1333333,28.06481
42040,18339,1847,3178,10175,13353,7637,3605,1656,10381,4749,1762,2744,1144,106,1282,.6940985,.8634361,.3599748,.0333543,.7505651,.3542998,.1627518,16.38087
42041,13942,976,1411,8194,9605,5462,2276,912,6555,2619,975,1093,343,63,673,.6895492,.7746279,.24309,.0446492,.6665853,.2777642,.111301,36.03112
42042,3864,273,415,2084,2499,1333,501,164,1639,589,183,306,88,19,171,.6263736,.7373494,.2120482,.0457831,.6396353,.2404031,.0786948,36.37513
42043,6444,480,587,3924,4511,2470,959,384,2935,1108,418,465,149,34,366,.7625,.7921636,.2538331,.0579216,.6294597,.2443935,.0978593,40.24871
42044,4027,265,304,2666,2970,1040,500,188,1240,583,206,200,83,18,205,.7735849,.6578947,.2730263,.0592105,.3900975,.1875469,.0705176,44.27711
42045,5404,374,421,3385,3806,1872,831,308,2172,925,317,300,94,9,304,.8128342,.7125891,.2232779,.0213777,.553028,.2454948,.0909897,38.27269
42046,20717,1700,3009,10776,13785,8063,3932,1670,10618,4596,1765,2555,664,95,841,.4947059,.8491193,.2206713,.031572,.7482368,.3648849,.154974,25.09133
42047,2249,169,288,1146,1434,627,274,123,808,338,157,181,64,34,99,.5857988,.6284722,.2222222,.1180556,.5471204,.2390925,.1073298,54.24048
42048,3739,241,325,2409,2734,1393,531,177,1633,590,189,240,59,12,186,.7717842,.7384616,.1815385,.0369231,.5782483,.2204234,.0734745,45.86537
42049,109435,8897,16456,61552,78008,46667,22322,10285,60408,28316,11502,13741,5994,1217,6420,.7215915,.8350146,.364244,.0739548,.758172,.3626527,.1670945,16.81625
42050,6692,455,574,4034,4608,2751,1037,433,3199,1187,476,448,150,43,318,.6989011,.7804878,.261324,.0749129,.6819534,.2570649,.1073376,34.93377
42051,70361,5954,11950,37190,49140,29311,15186,6821,39320,18812,7444,10009,3626,623,3914,.6573732,.8375732,.303431,.0521339,.788142,.4083356,.1834095,16.27631
42052,4700,362,499,2893,3392,1844,849,293,2214,932,308,370,83,15,248,.6850829,.741483,.1663327,.0300601,.6374006,.293467,.1012789,29.65173
42053,3674,253,295,2251,2546,1368,563,227,1583,614,235,215,51,8,205,.8102767,.7288136,.1728813,.0271186,.6077299,.2501111,.1008441,28.65294
42054,10911,826,961,6359,7320,3504,1354,524,4169,1515,567,665,161,43,556,.6731235,.6919875,.1675338,.0447451,.55103,.2129266,.0824029,45.92846
42055,3213,261,299,2012,2311,1399,485,216,1626,550,228,227,65,12,189,.7241379,.7591973,.2173913,.0401338,.6953281,.2410537,.1073559,32.52747
42056,11323,1042,1442,4450,5892,2104,1038,439,2916,1242,468,812,204,29,575,.5518234,.5631068,.1414702,.020111,.472809,.2332584,.0986517,63.48295
42057,9201,640,945,5720,6665,3533,1408,578,4213,1692,674,680,284,96,400,.625,.7195767,.3005291,.1015873,.6176574,.2461538,.101049,41.35318
42058,2533,211,290,1381,1671,938,424,201,1165,469,215,227,45,14,143,.6777251,.7827586,.1551724,.0482759,.6792179,.3070239,.1455467,15.71898
42059,1990,173,201,1141,1342,818,337,150,983,389,155,165,52,5,149,.8612717,.8208955,.2587065,.0248756,.716915,.295355,.1314636,33.90015
42060,7328,487,878,3186,4064,1868,849,470,2390,997,515,522,148,45,367,.7535934,.594533,.1685649,.0512528,.5863152,.2664783,.1475204,65.24775
42061,7268,484,728,4258,4986,2638,997,345,3210,1180,389,572,183,44,316,.6528926,.7857143,.2513736,.0604396,.6195397,.2341475,.081024,28.8921
42062,9255,574,777,6054,6831,3712,1520,585,4325,1691,620,613,171,35,422,.7351916,.7889318,.2200772,.045045,.6131483,.2510737,.0966303,40.07841
42063,10938,729,1123,6421,7544,4213,1672,671,5089,1902,706,876,230,35,500,.6858711,.7800534,.2048085,.0311665,.6561283,.2603956,.1045009,28.2623
42064,7011,447,619,4333,4952,2696,1118,430,3142,1285,447,446,167,17,333,.7449664,.720517,.26979,.0274637,.6222017,.2580198,.0992384,24.82322
42066,18952,1488,2687,10955,13642,7546,3972,1962,9762,5127,2148,2216,1155,186,1129,.7587366,.8247116,.4298474,.0692222,.6888179,.3625742,.1790963,28.70727
42067,2308,232,274,1025,1299,592,236,85,747,272,97,155,36,12,147,.6336207,.5656934,.1313869,.0437956,.577561,.2302439,.0829268,39.09196
43001,67346,4583,7093,41575,48668,25860,12502,7555,30760,14043,8080,4900,1541,525,3263,.711979,.6908219,.2172565,.0740166,.6220084,.3007096,.1817198,27.52151
43002,27916,1960,2970,16977,19947,8232,2715,1278,9951,3099,1389,1719,384,111,1199,.6117347,.5787879,.1292929,.0373737,.4848913,.1599222,.0752783,38.51538
43003,14901,934,1464,9468,10932,4390,1128,522,5317,1225,541,927,97,19,521,.5578158,.6331967,.0662568,.0129781,.4636671,.1191382,.0551331,41.33631
43004,9478,971,1430,5174,6604,2050,557,306,2961,877,339,911,320,33,578,.5952626,.637063,.2237762,.0230769,.3962118,.1076537,.0591419,67.68576
43005,77770,5370,9147,47762,56909,27276,11332,5413,33827,13483,5844,6551,2151,431,3613,.6728119,.7161911,.2351591,.0471193,.5710816,.2372597,.1133328,32.39724
43006,67547,5249,9152,38062,47214,20155,8815,3979,26449,11316,4335,6294,2501,356,3626,.6907982,.6877185,.2732736,.0388986,.5295308,.2315958,.10454,37.22639
43007,34923,2624,3662,20576,24238,7706,2716,1258,9782,3184,1347,2076,468,89,1398,.5327744,.5669034,.127799,.0243037,.374514,.1319984,.0611392,59.19841
43008,10234,720,1111,6298,7409,2810,828,384,3577,971,426,767,143,42,406,.5638889,.690369,.1287129,.0378038,.4461734,.1314703,.0609717,45.57476
43009,28285,1942,2924,17537,20461,7586,2747,1266,9535,3319,1354,1949,572,88,1309,.6740474,.6665527,.1956224,.0300958,.4325711,.1566402,.0721902,49.84981
43010,50205,3484,6114,30473,36587,14329,5508,2492,18449,6991,2789,4120,1483,297,2278,.6538461,.6738633,.2425581,.048577,.4702196,.1807502,.0817773,40.77651
43011,21616,1726,2449,12260,14709,6075,1887,807,7571,2138,823,1496,251,16,1040,.6025493,.6108616,.1024908,.0065333,.4955139,.1539152,.0658238,38.19155
43012,12727,1469,2442,7000,9442,3109,1176,538,5013,2127,598,1904,951,60,1103,.7508509,.7796888,.3894349,.02457,.4441428,.168,.0768571,52.48677
43013,24595,1831,3093,14138,17231,5487,1884,976,7439,2441,1044,1952,557,68,1123,.6133261,.6311025,.1800841,.0219851,.388103,.1332579,.0690338,66.51531
43014,7676,547,846,4689,5535,1606,417,248,2199,529,261,593,112,13,313,.572212,.7009456,.1323877,.0153664,.3425037,.0889315,.0528897,66.34628
43015,28792,1955,3259,17035,20294,6829,1919,898,8595,2220,956,1766,301,58,1167,.5969309,.541884,.0923596,.0177969,.4008805,.1126504,.052715,58.2419
43016,38311,2850,4275,22953,27228,12876,5717,3063,15766,6593,3339,2890,876,276,1997,.7007018,.6760234,.2049123,.0645614,.5609724,.2490742,.1334466,34.89622
43017,14941,1179,1590,9001,10591,4048,1169,494,5034,1365,523,986,196,29,707,.5996608,.6201258,.1232704,.018239,.4497278,.1298745,.0548828,57.20937
43018,28676,2169,3144,16977,20121,7541,2773,1465,9199,3063,1575,1658,290,110,1176,.5421854,.5273537,.0922392,.0349873,.4441892,.1633386,.0862932,63.97596
43019,477811,36307,71626,286211,357837,189125,98613,55675,245292,126420,63132,56167,27807,7457,25711,.7081555,.7841706,.388225,.1041102,.6607887,.3445465,.1945243,25.90689
43020,10857,726,1063,6864,7927,2917,866,334,3548,983,349,631,117,15,459,.6322314,.593603,.1100659,.014111,.4249709,.1261655,.0486597,53.66667
43021,13589,906,1421,8417,9838,3387,1087,510,4074,1266,555,687,179,45,431,.4757174,.4834624,.1259676,.0316678,.4023999,.1291434,.0605917,54.1556
43022,30037,2208,3174,17671,20845,8490,2493,1330,10498,2921,1426,2008,428,96,1386,.6277174,.6326402,.1348456,.0302457,.4804482,.1410786,.0752646,42.76716
43023,34663,2542,3893,20606,24499,8853,3324,1360,10936,3915,1446,2083,591,86,1564,.6152636,.5350629,.1518109,.0220909,.4296322,.1613122,.0660002,51.76942
43024,25305,2248,3011,13469,16480,5654,1933,925,7327,2293,999,1673,360,74,1505,.669484,.5556294,.1195616,.0245766,.4197788,.1435147,.0686762,76.99583
43025,14826,1073,1530,8584,10114,2885,874,562,3608,979,591,723,105,29,607,.5657036,.472549,.0686275,.0189542,.3360904,.1018173,.0654706,72.85149
43026,31983,2500,4221,18740,22961,9601,3615,1889,12599,4825,2017,2998,1210,128,1690,.676,.7102582,.2866619,.0303246,.5123266,.1929029,.1008004,42.27222
43027,49467,3580,5113,30672,35785,14283,4611,2010,17493,5448,2193,3210,837,183,2435,.6801676,.6278114,.1637004,.0357911,.465669,.1503326,.0655321,48.75274
43028,24625,1846,2773,15072,17845,7298,2363,1051,9156,2813,1161,1858,450,110,1138,.616468,.6700324,.1622791,.0396682,.4842091,.1567808,.069732,50.81149
43029,16751,1215,1921,9845,11766,3387,928,401,4472,1118,442,1085,190,41,653,.5374486,.56481,.0989068,.0213431,.3440325,.094261,.0407313,55.49191
43030,54422,3818,5855,33342,39197,15839,5750,2974,19483,6698,3092,3644,948,118,2427,.6356731,.6223741,.1619129,.0201537,.4750465,.1724552,.0891968,43.76041
43031,13787,969,1629,7632,9261,2512,775,369,3326,862,401,814,87,32,397,.4097007,.4996931,.053407,.019644,.3291405,.1015461,.0483491,65.60993
43032,49300,3422,5667,29078,34745,14820,5865,2678,18384,6952,2883,3564,1087,205,2235,.6531268,.6289042,.1918122,.0361743,.5096636,.2016989,.0920971,35.25081
43033,287740,20997,37371,171244,208615,109151,52877,26539,137920,66562,28914,28769,13685,2375,15438,.7352479,.7698215,.366193,.063552,.6374004,.3087816,.1549777,28.28711
43034,6887,481,801,4067,4868,1162,302,170,1652,395,179,490,93,9,210,.4365904,.6117353,.1161049,.011236,.2857143,.0742562,.0417999,71.90343
43035,23873,1773,2666,13647,16313,5289,1650,751,6663,1957,813,1374,307,62,1189,.6706148,.5153788,.1151538,.0232558,.3875577,.1209057,.0550304,67.29057
43036,22280,1527,2278,13633,15911,5946,1536,691,7372,1749,740,1426,213,49,950,.6221349,.6259877,.0935031,.0215101,.4361476,.1126678,.0506858,59.36619
43037,43751,2876,4705,26269,30974,12360,3578,1757,15328,4108,1853,2968,530,96,1673,.5817107,.6308183,.1126461,.0204038,.4705166,.1362062,.0668849,48.59126
43038,20318,1622,2401,11177,13578,4803,1856,882,6286,2217,999,1483,361,117,1063,.6553637,.6176593,.150354,.0487297,.4297217,.1660553,.078912,68.49954
43039,21390,1362,2277,12906,15183,5403,1458,683,6583,1751,727,1180,293,44,823,.6042584,.5182257,.1286781,.0193237,.4186425,.1129707,.0529211,55.30023
43040,28656,1758,2994,18211,21205,8609,2688,1256,10546,3135,1365,1937,447,109,1022,.5813425,.6469606,.1492986,.0364061,.4727363,.1476031,.0689693,43.1029
43041,15151,1101,2004,8944,10948,3673,1096,466,4651,1284,494,978,188,28,633,.5749319,.488024,.0938124,.0139721,.4106664,.1225403,.052102,48.39138
43042,6871,461,708,4175,4883,1928,600,320,2353,654,337,425,54,17,282,.6117136,.6002825,.0762712,.0240113,.4617964,.1437126,.0766467,59.5088
43043,15957,1083,1682,9498,11180,4935,1492,717,6101,1681,783,1166,189,66,664,.6131117,.6932223,.1123662,.039239,.519583,.1570857,.0754896,44.3273
43044,9398,635,953,5849,6802,1901,636,326,2506,767,364,605,131,38,315,.496063,.6348373,.1374606,.0398741,.3250128,.1087365,.055736,68.68798
43045,31284,2752,4457,18346,22803,8860,2977,1486,12196,4437,1639,3336,1460,153,2031,.7380087,.7484855,.3275746,.034328,.4829391,.1622697,.0809986,40.41982
43046,13745,958,1440,8292,9732,3024,918,344,3842,1056,369,818,138,25,506,.5281837,.5680556,.0958333,.0173611,.3646888,.1107091,.0414858,62.7288
43047,319694,24765,49605,189378,238983,121948,62678,35550,162504,84461,40200,40556,21783,4650,18525,.7480315,.8175789,.4391291,.0937406,.6439396,.3309677,.1877198,29.42822
43048,7455,521,844,4415,5259,1465,583,271,1969,675,289,504,92,18,322,.6180422,.5971564,.1090047,.021327,.3318233,.1320498,.0613817,66.77116
43049,24555,1766,2790,14201,16991,5732,1596,792,7429,2008,870,1697,412,78,1121,.6347678,.6082437,.1476703,.027957,.4036335,.1123865,.0557707,67.58604
43050,34110,2579,3872,19962,23834,8567,2612,1213,11028,3220,1370,2461,608,157,1539,.5967429,.6355888,.1570248,.0405475,.4291654,.1308486,.0607655,42.67381
43051,9700,670,1043,5520,6563,2730,1003,449,3372,1096,449,642,93,0,343,.5119403,.6155321,.0891659,0,.4945652,.1817029,.0813406,55.05042
43052,26483,2018,2726,16291,19017,7638,2406,1206,9324,2786,1289,1686,380,83,1342,.6650149,.6184886,.1393984,.0304475,.4688478,.1476889,.0740286,45.91065
43053,28553,1844,2908,17879,20787,8710,2772,1202,10625,3305,1279,1915,533,77,1305,.7077007,.6585282,.1832875,.0264787,.4871637,.1550422,.0672297,35.98536
43054,41878,2817,4700,24994,29694,11822,4331,1962,14973,5310,2136,3151,979,174,1611,.571885,.6704255,.2082979,.0370213,.4729935,.1732816,.0784988,44.0963
43055,22525,1461,2279,13890,16169,6021,1433,688,7518,1761,773,1497,328,85,951,.650924,.656867,.1439228,.0372971,.4334773,.1031677,.049532,58.58936
43056,15700,999,1637,9577,11214,3328,822,430,4309,936,444,981,114,14,463,.4634635,.5992669,.0696396,.0085522,.3474992,.0858306,.0448992,56.2254
43057,74546,5880,10185,43221,53406,24900,11190,5514,32366,14642,6022,7466,3452,508,4271,.7263606,.7330388,.3389298,.0498773,.5761088,.2589019,.1275769,45.02066
43058,24416,1831,2788,14179,16967,5968,1974,797,7539,2292,839,1571,318,42,995,.5434189,.5634864,.1140603,.0150646,.4209042,.13922,.0562099,48.48571
43059,19698,1313,2060,12284,14344,6073,1867,885,7346,2165,904,1273,298,19,816,.6214775,.6179612,.1446602,.0092233,.4943829,.1519863,.0720449,42.57016
43060,51095,3777,5925,30627,36552,16012,5807,2690,20008,6954,2854,3996,1147,164,2397,.6346307,.6744304,.1935865,.0276793,.5228066,.1896039,.087831,37.48969
43061,7431,540,791,4305,5096,1867,616,249,2293,724,261,426,108,12,354,.6555555,.5385588,.136536,.0151707,.4336818,.1430894,.0578397,65.37944
43062,28700,2216,3342,16584,19926,6501,2285,990,8363,2870,1094,1862,585,104,1394,.6290614,.5571514,.1750449,.0311191,.3920043,.1377834,.0596961,55.42995
43063,83342,7322,16536,43008,59544,28298,12284,6219,41498,16278,6969,13200,3994,750,4214,.5755258,.7982584,.2415336,.0453556,.6579706,.2856213,.144601,36.42443
43064,4510,311,501,2668,3169,1387,510,246,1715,568,246,328,58,0,191,.6141479,.6546906,.1157685,0,.5198651,.1911544,.0922039,43.17376
43065,16604,1249,1898,9529,11427,3861,821,370,5062,1008,391,1201,187,21,758,.6068855,.6327713,.0985248,.0110643,.4051842,.086158,.0388288,65.86443
43066,32781,2084,3328,20055,23383,10238,2991,1435,12444,3477,1535,2206,486,100,1247,.5983685,.6628606,.1460337,.0300481,.5104961,.1491399,.0715532,42.25566
43067,17575,1214,1764,10672,12436,3751,1109,632,4735,1299,671,984,190,39,740,.6095552,.5578231,.1077098,.0221088,.3514805,.1039168,.0592204,64.09357
43068,6111,390,586,3810,4396,1651,414,147,1998,487,164,347,73,17,237,.6076923,.5921502,.1245734,.0290102,.4333333,.1086614,.0385827,58.10474
43069,4358,296,430,2689,3119,977,306,155,1249,363,185,272,57,30,161,.5439189,.6325582,.1325581,.0697674,.3633321,.1137969,.0576422,61.96959
43070,13602,991,1426,7944,9370,3230,965,482,4097,1137,506,867,172,24,543,.5479314,.6079944,.1206171,.0168303,.4065962,.1214753,.0606747,41.80651
43071,47690,4723,9538,26547,36085,13276,6398,3743,21083,10530,4235,7807,4132,492,3605,.7632861,.8185154,.4332145,.0515831,.5000942,.2410065,.1409952,49.79172
43072,24235,1887,3147,13752,16899,6497,2319,1109,8406,2920,1178,1909,601,69,1213,.6428193,.6066095,.1909755,.0219256,.4724404,.16863,.0806428,52.02466
43073,48425,3493,4991,29496,34487,15958,6528,3121,19328,7498,3258,3370,970,137,2437,.6976811,.6752154,.1943498,.0274494,.5410225,.2213181,.105811,35.73552
43074,37021,2860,4282,21658,25940,11349,3393,1480,14123,3997,1593,2774,604,113,1723,.6024476,.6478281,.1410556,.0263895,.5240096,.1566627,.068335,42.91534
43075,84058,7345,14647,45765,60412,28740,12591,6757,40491,18309,7511,11751,5718,754,5610,.7637849,.8022803,.3903871,.0514781,.6279908,.2751229,.1476456,36.50462
43076,19259,1506,2236,10468,12704,3946,1005,531,5206,1174,566,1260,169,35,874,.5803453,.5635062,.0755814,.015653,.3769583,.0960069,.050726,69.40298
43077,8605,618,994,4906,5900,1923,523,279,2520,624,310,597,101,31,328,.5307443,.6006036,.1016097,.0311871,.391969,.1066042,.0568691,51.7669
43078,41418,2706,4476,25130,29606,12794,4946,2327,15489,5584,2425,2695,638,98,1608,.5942351,.6021001,.142538,.0218945,.5091126,.1968165,.0925985,49.97688
43079,777113,63013,111900,433723,545623,285697,138718,68875,370576,173748,76450,84879,35030,7575,42307,.6714011,.7585255,.3130473,.0676944,.6587085,.3198309,.1587995,32.97726
43080,14935,1020,1633,9160,10793,3943,1203,560,4960,1348,591,1017,145,31,577,.5656863,.6227801,.0887936,.0189835,.4304585,.1313319,.0611354,47.09892
43081,8665,557,817,5508,6325,2246,578,308,2807,670,322,561,92,14,288,.5170556,.6866585,.1126071,.0171359,.4077705,.1049383,.0559187,56.13577
43082,143968,9361,15207,88842,104049,50670,22532,11700,61052,25896,12534,10382,3364,834,6307,.6737528,.6827119,.2212139,.0548432,.5703384,.2536188,.1316945,29.29195
43083,85790,6131,8980,49480,58460,29947,12269,5830,36078,14064,6143,6131,1795,313,4167,.6796607,.6827394,.1998886,.0348552,.6052344,.2479588,.1178254,40.93612
43084,32930,2787,3964,18089,22053,8526,2618,1059,10916,3182,1129,2390,564,70,1826,.6551848,.6029263,.1422805,.0176589,.4713362,.1447288,.0585439,58.50139
43085,6137,356,688,3790,4478,1604,521,256,2052,597,263,448,76,7,229,.6432585,.6511628,.1104651,.0101744,.423219,.137467,.0675462,49.51456
43086,16362,1166,1674,10237,11911,4628,1774,792,5760,2065,857,1132,291,65,734,.6295026,.6762246,.1738351,.0388292,.4520856,.1732929,.0773664,37.68923
43087,11707,830,1397,6677,8074,2416,492,187,3146,613,220,730,121,33,388,.4674699,.5225483,.0866142,.023622,.3618391,.0736858,.0280066,55.35672
43088,4728,332,514,2723,3237,1064,284,135,1345,310,143,281,26,8,165,.4969879,.5466926,.0505837,.0155642,.3907455,.1042967,.0495777,63.65524
43089,32653,2278,3531,19509,23040,9463,2863,1307,11552,3249,1389,2089,386,82,1395,.6123793,.5916171,.1093175,.0232229,.4850582,.1467528,.0669947,46.60542
43090,88755,6893,13179,52387,65566,29936,14999,7857,39894,19872,8688,9958,4873,831,4924,.7143479,.755596,.3697549,.0630549,.5714395,.2863115,.14998,35.66943
43091,13946,1019,1479,8136,9615,3135,801,408,4126,898,422,991,97,14,652,.639843,.6700473,.0655849,.0094659,.3853245,.0984513,.0501475,57.91176
43092,32896,3228,6292,18746,25038,8535,3426,1837,13675,6152,2103,5140,2726,266,2501,.7747831,.8169104,.4332486,.0422759,.4552971,.182759,.0979942,45.52518
43093,19567,1328,1984,12142,14126,5079,1482,789,6403,1762,834,1324,280,45,730,.5496988,.6673387,.141129,.0226815,.4183001,.1220557,.0649811,54.60361
43094,58108,4070,5594,34201,39795,23575,13248,8073,27504,14570,8355,3929,1322,282,2964,.7282555,.7023597,.2363246,.0504112,.6893073,.3873571,.2360457,40.88143
43095,56064,4109,5809,33086,38895,20235,7765,3881,24017,8940,4087,3782,1175,206,2758,.6712095,.6510587,.2022723,.0354622,.611588,.2346914,.1173004,39.08576
44001,38381,2401,5681,22767,28448,11701,5159,1910,14280,5785,1972,2579,626,62,1659,.6909621,.4539694,.1101919,.0109136,.5139456,.2265999,.0838934,46.32908
44002,13323,968,1813,7037,8850,3884,1831,773,4948,2183,901,1064,352,128,562,.5805785,.5868726,.1941533,.0706012,.5519397,.2601961,.1098479,11.11443
44003,64172,4525,7635,36081,43716,19344,8951,4010,24031,10304,4203,4687,1353,193,2782,.6148067,.6138834,.1772102,.0252783,.536127,.2480807,.1111388,34.96428
44004,14260,1135,1287,8799,10086,5105,2346,1059,5804,2562,1112,699,216,53,831,.7321586,.5431235,.1678322,.041181,.5801796,.2666212,.1203546,35.88135
44005,7266,565,792,4360,5152,2475,964,359,3047,1105,391,572,141,32,382,.6761062,.7222222,.1780303,.040404,.5676606,.2211009,.0823395,19.96127
44006,1994,122,148,1325,1473,877,446,189,978,494,196,101,48,7,90,.7377049,.6824324,.3243243,.0472973,.6618868,.3366038,.1426415,16.51139
44007,25055,2022,2651,13699,16350,6288,2561,1188,7899,2919,1258,1611,358,70,1382,.6834817,.6076952,.1350434,.0264051,.4590116,.186948,.0867217,54.42751
44008,17726,1225,1641,11046,12687,5035,2135,840,6102,2448,910,1067,313,70,909,.7420408,.6502133,.1907374,.0426569,.4558211,.1932826,.0760456,46.79524
44009,8168,734,927,4432,5359,2169,944,397,2655,1095,413,486,151,16,469,.6389646,.5242718,.162891,.01726,.4893953,.2129964,.0895758,32.47343
44010,7084,438,541,4793,5334,3110,1367,667,3475,1464,667,365,97,0,323,.7374429,.6746765,.1792976,0,.6488629,.2852076,.1391613,39.76022
44011,24726,1782,2664,14878,17542,7296,3324,1514,8862,3779,1651,1566,455,137,1222,.6857464,.5878378,.1707958,.0514264,.4903885,.2234171,.101761,55.64332
44012,4919,303,435,3414,3849,1717,743,264,1985,804,286,268,61,22,200,.660066,.616092,.1402299,.0505747,.5029291,.2176333,.0773286,28.77415
44013,26030,2159,3985,13528,17513,6801,3461,1426,9550,4574,1697,2749,1113,271,1478,.6845762,.6898369,.2792974,.068005,.5027351,.2558397,.105411,46.44845
44014,157889,14223,33532,78610,112142,52710,26425,12425,77707,32799,13765,24997,6374,1340,6733,.4733882,.745467,.1900871,.0399618,.6705254,.3361531,.1580588,33.70319
44015,988800,83036,140362,531883,672245,335685,181436,84968,434779,218280,92064,99094,36844,7096,52203,.6286792,.7059888,.2624927,.050555,.6311256,.3411201,.1597494,34.76189
44016,4681,255,396,3119,3515,1693,874,408,1999,982,421,306,108,13,147,.5764706,.7727273,.2727273,.0328283,.5428022,.280218,.1308112,38.20781
44017,859,81,84,502,586,257,121,56,308,137,64,51,16,8,62,.7654321,.6071429,.1904762,.0952381,.5119522,.2410359,.1115538,27.3
44018,13401,774,1096,9380,10476,4525,2231,910,5086,2381,954,561,150,44,496,.6408269,.5118613,.1368613,.040146,.4824094,.2378465,.0970149,41.38157
44019,75301,5071,7775,44860,52635,26885,12074,5258,32202,13894,5592,5317,1820,334,3770,.7434431,.6838585,.2340836,.0429582,.599309,.2691485,.1172091,38.84724
44020,169587,12945,24184,92453,116637,60282,29666,12533,75426,35207,13663,15144,5541,1130,8531,.6590189,.6261991,.2291184,.0467251,.6520286,.3208765,.1355608,22.80053
44021,93588,12140,33131,39405,72536,27213,18836,12552,57833,40635,15935,30620,21799,3383,10565,.8702636,.92421,.6579638,.1021098,.6905977,.4780104,.3185382,39.55526
44022,7573,750,1536,4043,5579,2728,1842,950,3962,2548,1064,1234,706,114,639,.852,.8033854,.4596354,.0742188,.6747465,.4556023,.234974,44.9589
44023,2579,160,229,1568,1797,831,386,126,963,421,143,132,35,17,126,.7875,.5764192,.1528384,.0742358,.5299745,.2461735,.0803571,36.55381
44024,8428,752,983,4594,5577,1869,857,407,2437,995,443,568,138,36,502,.6675532,.577823,.1403866,.0366226,.406835,.1865477,.0885938,53.07256
44025,33057,2345,4023,19843,23866,11347,5320,2437,14274,6501,2602,2927,1181,165,1656,.7061834,.7275665,.293562,.0410142,.5718389,.2681046,.1228141,36.58385
44026,12313,780,1266,7576,8842,3205,1166,610,3992,1396,638,787,230,28,556,.7128205,.6216429,.1816746,.0221169,.4230465,.1539071,.0805174,53.36193
44027,17803,1094,1348,12021,13369,6215,2793,1186,6934,2988,1205,719,195,19,747,.6828154,.5333828,.1446588,.014095,.5170119,.2323434,.0986607,33.54146
44028,23637,3188,3726,12515,16241,5907,2830,1381,7509,3279,1474,1602,449,93,1166,.3657466,.4299517,.1205046,.0249597,.4719936,.2261287,.1103476,54.19057
44029,19574,1714,2435,10699,13134,5748,2571,1074,7298,2889,1134,1550,318,60,1082,.6312719,.6365503,.1305955,.0246407,.5372465,.2403028,.1003832,34.17323
44030,10992,697,980,7074,8054,3858,1692,697,4533,1899,705,675,207,8,524,.7517934,.6887755,.2112245,.0081633,.5453774,.2391858,.0985298,32.77533
44031,209727,16936,24027,105162,129189,46104,24530,10994,59190,29652,11814,13086,5122,820,12524,.7394899,.5446373,.2131768,.0341283,.4384093,.2332592,.1045435,59.03671
44032,9275,609,964,5646,6610,2868,1112,419,3532,1316,447,664,204,28,398,.6535304,.6887967,.2116183,.0290456,.5079703,.1969536,.0742118,48.05595
44033,6672,423,645,4026,4671,2530,1188,541,2991,1330,578,461,142,37,347,.820331,.7147287,.220155,.0573643,.6284153,.295082,.1343766,18.31882
44034,29430,2190,2951,17600,20551,9237,3613,1458,11189,4106,1552,1952,493,94,1521,.6945205,.6614707,.167062,.0318536,.5248296,.2052841,.0828409,45.5691
44035,10556,917,1094,5250,6344,2747,1392,691,3363,1556,728,616,164,37,667,.7273719,.5630713,.1499086,.0338208,.5232381,.2651429,.1316191,33.27475
44036,18538,1363,2262,10189,12451,5859,2612,1021,7298,3075,1077,1439,463,56,918,.6735143,.6361627,.2046861,.0247569,.5750319,.2563549,.1002061,31.61889
44037,38127,2644,4190,23473,27663,11652,5651,2424,14120,6329,2496,2468,678,72,1727,.653177,.5890215,.1618138,.0171838,.4964001,.2407447,.1032676,49.75322
44038,6950,491,616,4533,5149,2161,894,356,2542,1005,380,381,111,24,312,.6354379,.6185065,.1801948,.038961,.4767262,.1972204,.0785352,33.51191
44039,9582,623,956,6112,7068,3075,1061,421,3727,1289,455,652,228,34,438,.7030498,.6820084,.2384937,.0355649,.5031086,.1735929,.0688809,24.02442
44040,4825,420,526,2504,3030,1197,578,255,1469,685,276,272,107,21,333,.7928572,.5171103,.2034221,.039924,.4780352,.2308307,.1018371,31.19396
44041,3196,188,251,2183,2434,1151,487,230,1316,546,239,165,59,9,152,.8085107,.6573705,.2350598,.0358566,.5272561,.2230875,.1053596,20.86743
44042,10439,682,897,6985,7882,3100,1277,509,3547,1380,528,447,103,19,450,.6598241,.4983278,.1148272,.0211817,.4438082,.1828203,.0728704,39.9642
44043,144576,10221,13570,79906,93476,60752,37573,21484,70442,40994,22357,9690,3421,873,7246,.7089326,.7140751,.2521002,.0643331,.7602934,.470215,.2688659,33.58814
44044,4648,339,416,2892,3308,1540,785,393,1797,877,402,257,92,9,248,.7315634,.6177884,.2211538,.0216346,.5325035,.2714384,.1358921,38.66084
44045,18823,1282,1978,11688,13666,4949,2114,999,6297,2436,1043,1348,322,44,819,.6388456,.6814964,.1627907,.0222447,.4234257,.1808693,.0854723,41.85006
44046,36446,2534,3540,22917,26457,13748,6868,3428,16108,7602,3587,2360,734,159,1840,.7261247,.6666667,.2073446,.0449153,.599904,.2996902,.1495833,32.12006
44047,12617,716,997,8468,9465,3784,1539,712,4408,1724,758,624,185,46,420,.5865922,.6258776,.1855567,.0461384,.4468588,.181743,.0840812,42.02106
44048,2915,174,217,1877,2094,913,482,231,1043,514,231,130,32,0,143,.8218391,.5990784,.1474654,0,.4864145,.2567928,.1230687,39.93541
44049,27656,2201,3331,16260,19591,9454,4739,1648,11868,5444,1751,2414,705,103,1410,.6406179,.7247073,.2116482,.0309216,.5814268,.2914514,.101353,29.80209
44050,56767,7082,17344,23744,41088,17137,7189,2888,30232,9285,3184,13095,2096,296,1961,.2768992,.7550161,.1208487,.0170664,.7217402,.3027712,.1216307,37.29586
44051,2947,181,289,1905,2194,798,324,143,943,369,152,145,45,9,109,.6022099,.5017301,.1557093,.0311419,.4188976,.1700787,.0750656,47.86002
44052,4600,344,558,2439,2997,1406,552,174,1671,625,182,265,73,8,202,.5872093,.4749104,.1308244,.0143369,.5764658,.2263223,.0713407,10.81081
44053,4608,336,550,2488,3038,1252,520,234,1513,617,255,261,97,21,197,.5863096,.4745454,.1763636,.0381818,.5032154,.2090032,.0940515,26.20658
44054,8859,730,949,4798,5747,2173,966,388,2689,1099,432,516,133,44,504,.690411,.5437303,.1401475,.0463646,.452897,.2013339,.080867,39.15229
44055,3315,281,412,1617,2029,716,288,158,977,350,178,261,62,20,166,.5907474,.6334952,.1504854,.0485437,.4427953,.1781076,.0977118,40.77977
44056,6531,463,680,3666,4346,2129,686,289,2582,793,312,453,107,23,252,.5442765,.6661765,.1573529,.0338235,.5807419,.1871249,.0788325,25.78451
44057,1556390,111252,216249,889612,1105861,633402,368576,194316,788816,438818,214865,155414,70242,20549,72876,.6550534,.7186808,.32482,.0950247,.711998,.414311,.2184278,18.8031
44058,16184,1204,1768,9050,10818,3886,1634,747,4923,1941,808,1037,307,61,774,.6428571,.5865384,.1736425,.0345023,.4293923,.1805525,.0825414,34.99051
44059,21165,1743,2419,10683,13102,5488,2616,1345,6951,3001,1400,1463,385,55,1085,.62249,.6047954,.1591567,.0227367,.5137134,.244875,.125901,35.53725
44060,4839,316,379,3262,3641,1356,511,245,1642,624,269,286,113,24,239,.7563291,.7546174,.298153,.0633245,.4156959,.1566524,.0751073,52.94426
44061,143126,11260,23594,77927,101521,59954,37446,20318,79706,49164,22553,19752,11718,2235,8680,.7708703,.837162,.4966517,.0947275,.7693611,.4805267,.2607312,26.14062
44062,18903,1326,1813,12025,13838,4746,1981,891,5898,2216,932,1152,235,41,921,.6945701,.6354109,.1296194,.0226145,.3946778,.1647401,.0740956,51.28574
44063,3539,228,304,2253,2557,909,319,136,1118,358,152,209,39,16,130,.5701754,.6875,.1282895,.0526316,.4034621,.141589,.060364,42.24138
44064,11367,1003,1373,5627,7000,1992,875,426,2689,1123,464,697,248,38,683,.6809571,.5076475,.1806264,.0276766,.3540075,.1555003,.0757064,68.40784
44065,4075,337,479,2654,3133,1395,747,270,1762,871,273,367,124,3,276,.8189911,.7661796,.2588727,.006263,.5256217,.281462,.1017332,34.3018
44066,12517,1059,1380,6757,8137,2470,930,469,3151,1126,477,681,196,8,711,.6713881,.4934783,.142029,.0057971,.3655469,.1376351,.0694095,56.33984
44067,19480,1488,2420,12668,15088,6315,3293,1094,8052,3898,1152,1737,605,58,1167,.7842742,.7177686,.25,.0239669,.4985002,.2599463,.0863593,39.02365
44068,115374,8776,16986,62515,79501,38167,18503,7495,49407,22492,8276,11240,3989,781,5442,.6201003,.6617214,.2348405,.045979,.6105255,.295977,.1198912,17.68721
44069,2033,150,145,1149,1294,577,237,123,625,252,136,48,15,13,98,.6533333,.3310345,.1034483,.0896552,.5021758,.2062663,.1070496,36.8984
44070,59743,4763,6779,34304,41083,19118,8005,3373,23657,9369,3563,4539,1364,190,3146,.6605081,.6695678,.2012096,.0280277,.5573111,.2333547,.0983267,39.34773
44071,479899,41818,70986,239946,310932,142795,72962,33585,192439,90593,36273,49644,17631,2688,28701,.6863313,.6993492,.2483729,.0378666,.595113,.3040768,.139969,29.50497
44072,22560,1869,3821,13575,17396,7917,4316,2014,11027,6032,2302,3110,1716,288,1450,.775816,.8139231,.4490971,.0753729,.5832044,.3179374,.148361,35.75788
44073,17946,1292,1693,11537,13230,4877,2130,971,5989,2386,1025,1112,256,54,916,.7089784,.6568222,.1512109,.031896,.4227269,.1846234,.084164,57.41173
44074,24285,1528,2096,16043,18139,7545,3251,1461,8930,3621,1542,1385,370,81,1142,.7473822,.6607825,.1765267,.038645,.4702986,.2026429,.0910678,47.92797
44075,18832,1085,1799,12711,14510,5063,2010,960,6376,2422,1071,1313,412,111,792,.7299539,.7298499,.2290161,.0617009,.3983164,.1581308,.0755251,52.5
44076,5891,392,435,3804,4239,1789,741,325,2098,833,339,309,92,14,306,.7806122,.7103449,.2114943,.0321839,.4702944,.194795,.0854364,34.23742
44077,9834,724,982,5519,6501,2491,1054,522,3117,1194,551,626,140,29,484,.6685083,.6374745,.1425662,.0295316,.4513499,.1909766,.0945823,30.61258
44078,2158,156,165,1456,1621,691,342,145,788,387,154,97,45,9,132,.8461539,.5878788,.2727273,.0545455,.4745879,.2348901,.0995879,40.71021
44079,130846,8422,14208,71297,85505,51072,32485,18170,59704,35616,18855,8632,3131,685,5754,.6832106,.607545,.2203688,.0482123,.7163275,.4556293,.2548494,44.78047
44080,6893,407,596,4458,5054,2273,864,303,2647,955,315,374,91,12,253,.6216216,.6275168,.1526846,.0201342,.5098699,.1938089,.0679677,46.13113
44081,14830,935,1491,9210,10701,4536,1864,716,5554,2040,759,1018,176,43,631,.6748663,.6827632,.1180416,.0288397,.4925081,.2023887,.0777416,56.79661
44082,13785,1075,1605,6849,8454,2789,1314,658,3514,1508,692,725,194,34,617,.5739535,.4517134,.1208723,.0211838,.4072127,.1918528,.0960724,62.3348
44083,13150,1077,1698,6793,8491,3456,1580,721,4283,1812,744,827,232,23,688,.6388115,.4870436,.1366313,.0135453,.508759,.2325924,.1061387,22.97747
44084,195940,14807,24714,113085,137799,73826,37559,17424,90886,44604,19176,17060,7045,1752,10203,.689066,.690297,.2850611,.070891,.6528364,.3321307,.1540788,26.04835
44085,5336,370,581,3065,3646,1361,652,298,1651,707,313,290,55,15,185,.5,.4991394,.0946644,.0258176,.4440457,.2127243,.0972268,25.58751
44086,13532,852,1238,9119,10357,4859,2215,1033,5710,2465,1075,851,250,42,498,.584507,.687399,.2019386,.0339257,.5328435,.2428994,.11328,34.20161
44087,1304,106,153,659,812,339,138,70,429,146,72,90,8,2,80,.754717,.5882353,.0522876,.0130719,.5144158,.2094082,.1062215,16.73747
44088,5193,355,537,3080,3617,1367,659,252,1734,738,270,367,79,18,237,.6676056,.6834264,.1471136,.0335196,.4438312,.213961,.0818182,51.86875
44089,16883,1167,1629,10111,11740,4134,1725,792,5175,1933,856,1041,208,64,832,.7129391,.6390424,.1276857,.0392879,.4088616,.1706063,.0783305,55.03259
44090,26386,1779,2947,16199,19146,9939,4070,1823,11885,4624,1987,1946,554,164,1037,.5829117,.6603326,.1879878,.0556498,.6135564,.2512501,.1125378,14.44078
44091,89796,6332,10764,55262,66026,33422,16312,7138,41074,19320,7484,7652,3008,346,4370,.6901453,.7108881,.27945,.0321442,.6047917,.2951757,.1291665,30.45842
44092,99487,7778,13451,56989,70440,37326,19493,8291,46922,23730,8972,9596,4237,681,5603,.7203651,.7134042,.3149952,.0506282,.6549685,.3420485,.1454842,30.62477
44093,13580,947,1497,8136,9633,3709,1838,820,4528,2026,858,819,188,38,706,.7455121,.5470942,.1255845,.0253841,.4558751,.2259095,.1007866,62.30111
44094,46708,3924,5874,26783,32657,15416,6741,2989,19506,8221,3163,4090,1480,174,3016,.7686034,.6962887,.2519578,.0296221,.575589,.2516895,.1116006,42.60527
44095,37592,3105,4639,20292,24931,10819,5356,2244,13826,6420,2439,3007,1064,195,2159,.6953301,.6482,.2293598,.0420349,.5331658,.2639464,.1105855,32.61238
44096,5594,335,488,3602,4090,1729,651,237,1967,751,258,238,100,21,174,.519403,.4877049,.204918,.0430328,.4800111,.1807329,.0657968,40.10132
44097,8297,490,622,5850,6472,2674,1109,553,3082,1214,575,408,105,22,332,.677551,.6559486,.1688103,.0353698,.457094,.1895726,.0945299,45.62988
44098,6209,440,633,3591,4224,2388,1176,444,2800,1283,457,412,107,13,260,.5909091,.6508689,.1690363,.0205371,.6649958,.3274854,.1236424,12.80073
44099,6368,409,497,4102,4599,1938,845,422,2233,935,441,295,90,19,318,.7775061,.5935614,.1810865,.0382294,.4724525,.2059971,.1028766,38.78851
44100,40721,2781,4381,23111,27492,13112,4944,2101,16070,5650,2172,2958,706,71,1929,.6936354,.6751883,.1611504,.0162063,.5673489,.2139241,.0909091,34.86737
44101,2409547,169415,343331,1342703,1686034,947122,562083,309431,1181960,663938,339358,234838,101855,29927,110432,.6518431,.6839988,.2966671,.0871666,.7053846,.4186205,.2304538,21.44833
44102,52265,3980,6447,30086,36533,16963,8137,3715,21465,9854,3996,4502,1717,281,2680,.6733668,.6983093,.2663254,.0435862,.5638171,.270458,.1234794,46.07926
44103,3987,245,311,2451,2762,1790,917,446,2000,982,466,210,65,20,196,.8,.6752412,.2090032,.0643087,.7303141,.374133,.1819665,13.08074
44104,7725,470,696,5067,5763,2237,1039,551,2560,1114,569,323,75,18,348,.7404255,.4640805,.1077586,.0258621,.4414841,.2050523,.1087428,37.04437
44105,40594,5952,12926,17839,30765,11081,7126,4028,22810,14822,4810,11729,7696,782,5205,.874496,.907396,.5953891,.0604982,.6211671,.3994619,.2257974,50.20304
44106,5304,387,750,2808,3558,1584,630,268,2031,760,273,447,130,5,204,.5271318,.596,.1733333,.0066667,.5641026,.224359,.0954416,20.90113
44107,42606,2984,4262,27370,31632,13864,6163,2310,16713,7078,2374,2849,915,64,2083,.6980563,.6684655,.2146879,.0150164,.50654,.2251735,.084399,47.1584
44108,283229,23242,34019,138018,172037,56679,30604,14845,75047,37758,15943,18368,7154,1098,16906,.7273901,.5399336,.2102942,.0322761,.4106638,.2217392,.1075584,65.04737
44109,25024,1647,2482,16323,18805,7431,3300,1302,9005,3857,1374,1574,557,72,1162,.7055252,.634166,.2244158,.0290089,.4552472,.2021687,.0797647,48.64692
44110,23230,2075,3455,11893,15348,6142,2986,1181,8541,3859,1229,2399,873,48,1394,.6718072,.694356,.2526773,.0138929,.5164382,.251072,.0993021,31.46187
44111,17714,1052,1822,11421,13243,7128,3610,1494,8375,3986,1585,1247,376,91,721,.6853612,.6844127,.2063666,.0499451,.6241135,.3160844,.1308117,34.03028
44112,25247,1606,2529,15626,18155,8018,3406,1614,9553,3839,1729,1535,433,115,1023,.6369863,.6069593,.1712139,.0454725,.5131192,.21797,.1032894,43.28962
44113,22299,1333,2264,14593,16857,7077,3065,1144,8416,3418,1201,1339,353,57,986,.7396849,.5914311,.1559187,.0251767,.4849585,.2100322,.0783937,65.02739
44114,33142,2364,3884,19803,23687,10760,4875,1989,13163,5573,2056,2403,698,67,1652,.6988156,.618692,.1797116,.0172503,.543352,.2461748,.1004393,19.9289
44115,2728,237,342,1384,1726,641,269,129,807,306,137,166,37,8,138,.5822785,.4853801,.1081871,.0233918,.4631503,.1943642,.0932081,37.59
44116,55248,4412,7722,32681,40403,18505,8948,4484,24639,12088,4885,6134,3140,401,3127,.7087489,.7943538,.4066304,.0519296,.5662311,.2737982,.1372051,36.13014
44117,26304,1770,3002,16013,19015,10316,4723,1986,12385,5399,2116,2069,676,130,1219,.6887006,.6892072,.2251832,.0433045,.6442266,.2949479,.1240242,12.00908
44118,1386,103,128,826,954,488,244,96,582,261,102,94,17,6,63,.6116505,.734375,.1328125,.046875,.590799,.2953995,.1162228,23.53896
44119,7408,448,739,4698,5437,2315,868,317,2802,972,339,487,104,22,302,.6741071,.6589987,.1407307,.02977,.4927629,.1847595,.0674755,24.88907
44120,13352,967,1664,7802,9466,3548,1431,689,4554,1707,761,1006,276,72,663,.6856257,.6045673,.1658654,.0432692,.4547552,.1834145,.0883107,39.21821
44121,30781,2326,3167,17930,21097,9258,3284,1379,11210,3688,1442,1952,404,63,1624,.6981943,.6163562,.1275655,.0198926,.5163413,.1831567,.0769102,45.00158
44122,1647,107,152,1017,1169,559,362,228,658,397,234,99,35,6,73,.682243,.6513158,.2302632,.0394737,.5496559,.3559489,.2241888,41.55284
44123,250938,19245,34059,145625,179684,92407,44740,19772,118957,55048,21824,26550,10308,2052,14251,.740504,.7795296,.3026513,.0602484,.6345545,.3072275,.1357734,22.48425
44124,5168,417,505,2780,3285,967,485,260,1285,587,276,318,102,16,281,.6738609,.629703,.2019802,.0316832,.3478417,.1744604,.0935252,72.41093
44125,36498,3071,4593,19263,23856,8304,3752,1691,11060,4540,1819,2756,788,128,1918,.6245522,.6000435,.1715654,.0278685,.4310855,.1947775,.0877849,50.68398
44126,67649,4958,7508,39373,46881,23727,10431,4130,28988,12170,4361,5261,1739,231,3242,.6538927,.7007192,.2316196,.0307672,.6026211,.2649277,.1048942,25.09365
44127,17268,1220,1555,10813,12368,5101,2256,1067,5972,2531,1133,871,275,66,856,.7016394,.5601286,.1768489,.0424437,.471747,.2086377,.0986775,31.23202
44128,13593,1168,1520,7743,9263,3006,1341,663,3875,1563,729,869,222,66,880,.7534246,.5717105,.1460526,.0434211,.3882216,.1731887,.0856257,55.21794
44129,39015,2917,4229,23406,27635,12175,5299,2508,14795,6044,2579,2620,745,71,1899,.6510113,.6195318,.1761646,.0167888,.5201657,.2263949,.107152,44.17569
44130,10635,762,885,6747,7632,4382,2393,1160,4903,2530,1176,521,137,16,558,.7322835,.5887006,.1548023,.0180791,.6494738,.3546762,.1719283,34.90864
44131,543,66,94,295,389,100,61,49,129,67,49,29,6,0,28,.4242424,.3085106,.0638298,0,.3389831,.2067797,.1661017,77.38246
44132,1145,81,117,747,864,395,184,73,475,213,75,80,29,2,60,.7407407,.6837607,.2478632,.017094,.5287818,.2463186,.0977242,29.73309
44133,28780,1768,2615,19545,22160,12540,6879,3293,14224,7446,3435,1684,567,142,1183,.6691176,.643977,.216826,.0543021,.6415963,.351957,.168483,31.42148
44134,4063,280,333,2631,2964,1365,479,210,1500,502,215,135,23,5,175,.625,.4054054,.0690691,.015015,.5188141,.18206,.0798176,35.59119
44135,425,24,54,236,290,159,57,19,199,73,25,40,16,6,21,.875,.7407407,.2962963,.1111111,.6737288,.2415254,.0805085,38.97181
44136,2279,187,202,1345,1547,540,248,100,661,281,109,121,33,9,146,.7807487,.5990099,.1633663,.0445545,.401487,.1843866,.0743494,51.75476
44137,33358,3186,6764,16058,22822,9448,5643,2914,14756,8335,3379,5308,2692,465,2373,.7448211,.7847428,.3979894,.0687463,.5883672,.3514136,.1814672,43.71518
44138,5329,347,473,3416,3889,1561,716,323,1856,796,344,295,80,21,244,.70317,.6236786,.1691332,.0443975,.4569672,.2096019,.094555,40.40852
44139,42156,2998,4682,25474,30156,13536,6171,2554,16593,7150,2722,3057,979,168,1979,.6601067,.6529261,.2090987,.0358821,.5313653,.242247,.1002591,46.00185
44140,18669,1406,1823,10634,12457,4940,2272,1078,5991,2592,1163,1051,320,85,929,.6607397,.5765222,.1755348,.0466264,.4645477,.2136543,.101373,36.3123
44141,12005,904,1099,7365,8464,4194,1962,969,4899,2084,992,705,122,23,731,.8086283,.6414922,.11101,.0209281,.5694501,.2663951,.1315682,40.63229
44142,5514,484,649,2907,3556,863,426,226,1068,483,233,205,57,7,295,.6095041,.3158706,.0878274,.0107858,.2968696,.1465428,.0777434,64.89895
44143,19004,1204,1773,12357,14130,4765,1875,1003,5998,2166,1041,1233,291,38,867,.7200997,.6954315,.1641286,.0214326,.3856114,.1517359,.0811686,53.52906
44144,10952,914,1131,6536,7667,2844,1425,628,3665,1592,699,821,167,71,672,.7352297,.7259063,.1476569,.0627763,.4351285,.2180233,.0960832,53.44205
44145,9594,607,793,6386,7179,2893,1206,555,3415,1352,568,522,146,13,459,.7561779,.6582597,.184111,.0163934,.4530222,.1888506,.0869089,66.41579
44146,47088,3409,5112,27027,32139,13538,5386,2178,16482,6050,2336,2944,664,158,2176,.6383104,.5758998,.1298905,.0309077,.5009065,.1992822,.0805861,43.95302
44147,20224,1313,2134,13012,15146,5542,2269,922,6853,2635,994,1311,366,72,802,.6108149,.6143393,.1715089,.0337395,.4259145,.1743775,.0708577,55.06815
44148,3766,264,337,2244,2581,1441,703,364,1668,770,375,227,67,11,179,.6780303,.6735905,.1988131,.0326409,.6421568,.3132799,.1622103,22.51108
44149,9606,686,1080,5636,6716,2674,1163,578,3349,1339,601,675,176,23,444,.6472303,.625,.162963,.0212963,.47445,.206352,.102555,49.96718
44150,10144,487,542,7887,8429,4422,2287,1021,4791,2454,1059,369,167,38,385,.7905544,.6808118,.3081181,.0701107,.5606695,.2899708,.1294535,36.06038
44151,91,8,11,69,80,38,17,3,43,17,3,5,0,0,4,.5,.4545455,0,0,.5507246,.2463768,.0434783,22.32143
44152,211651,19523,42415,107949,150364,71681,41312,21665,106431,61335,25873,34750,20023,4208,14839,.7600778,.8192856,.4720736,.0992102,.6640266,.3826993,.2006966,25.10565
44153,8605,704,790,4746,5536,2022,993,474,2449,1102,495,427,109,21,556,.7897727,.5405063,.1379747,.0265823,.426043,.2092288,.0998736,38.17041
44154,8735,591,712,5721,6433,2573,1294,632,3041,1386,650,468,92,18,407,.6886633,.6573034,.1292135,.0252809,.4497465,.2261842,.1104702,39.51495
44155,170755,14651,28156,96731,124887,56630,28803,14054,78940,40255,15667,22310,11452,1613,11459,.7821309,.7923711,.4067339,.057288,.585438,.2977639,.1452895,30.87914
44156,789,47,73,514,587,265,155,79,313,176,81,48,21,2,42,.893617,.6575342,.2876712,.0273973,.5155642,.3015564,.1536965,45.20548
44157,10649,1625,2837,5249,8086,2554,1126,615,3555,1308,627,1001,182,12,867,.5335385,.3528375,.0641523,.0042298,.4865689,.2145171,.1171652,55.44765
44158,10360,818,986,6385,7371,3092,1114,414,3756,1297,454,664,183,40,617,.7542787,.673428,.1855984,.040568,.48426,.1744714,.0648395,58.85474
44159,4684,367,463,2650,3113,1264,507,178,1564,588,197,300,81,19,245,.6675749,.6479481,.174946,.0410367,.4769811,.1913208,.0671698,25.69275
44160,3683,235,272,2512,2784,1269,737,365,1418,763,373,149,26,8,173,.7361702,.5477941,.0955882,.0294118,.5051752,.2933917,.1453025,41.02041
44161,37828,2842,4869,20921,25790,11214,5120,2279,14313,6102,2510,3099,982,231,1927,.6780436,.6364757,.2016841,.047443,.5360165,.2447302,.1089336,41.10354
44162,31398,2680,3694,14404,18098,4637,2590,1205,6332,3262,1354,1695,672,149,1886,.7037314,.4588522,.1819166,.0403357,.3219245,.1798112,.0836573,68.55425
44163,23164,1778,2323,13351,15674,6066,2429,996,7303,2747,1084,1237,318,88,1217,.6844769,.5325011,.1368919,.037882,.454348,.1819339,.0746012,49.08435
44164,2346,174,179,1558,1737,693,342,196,755,358,202,62,16,6,140,.8045977,.3463687,.0893855,.0335196,.444801,.2195122,.1258023,43.9658
44165,82636,6086,10938,46887,57825,33984,20715,11391,41564,23778,12418,7580,3063,1027,4272,.7019389,.6929969,.2800329,.0938928,.7248064,.4418069,.2429458,15.92846
44166,22732,1490,2180,13880,16060,6307,2396,1069,7852,2832,1114,1545,436,45,1004,.6738255,.7087156,.2,.0206422,.4543948,.1726225,.0770173,49.06969
44167,4477,220,339,3142,3481,1424,713,362,1664,757,366,240,44,4,152,.6909091,.7079646,.1297935,.0117994,.4532145,.2269255,.1152132,41.81299
44168,9088,661,826,5534,6360,2608,1107,447,3141,1251,464,533,144,17,404,.6111951,.6452785,.1743341,.0205811,.4712685,.2000361,.0807734,36.55989
44169,17410,1155,1524,11449,12973,5293,2101,863,6205,2303,880,912,202,17,747,.6467533,.5984252,.1325459,.0111549,.4623111,.1835095,.0753778,36.01958
44170,128487,9893,13074,71701,84775,47156,23180,11047,55458,25525,11510,8302,2345,463,6830,.6903871,.6350008,.1793636,.0354138,.6576756,.323287,.1540704,43.77424
44171,16575,1160,1908,8938,10846,5338,2146,990,6544,2457,1052,1206,311,62,723,.6232759,.6320755,.1629979,.0324948,.5972253,.2400985,.110763,10.14195
44172,14629,920,1636,8628,10264,4657,1993,838,5774,2291,878,1117,298,40,615,.6684783,.6827629,.1821516,.0244499,.5397543,.2309921,.0971256,36.87391
44173,1950,108,133,1329,1462,689,308,140,786,335,144,97,27,4,87,.8055556,.7293233,.2030075,.0300752,.5184349,.2317532,.1053424,35.76973
44174,46786,4908,11443,24176,35619,14007,8043,4421,24013,14223,5238,10006,6180,817,4082,.8317034,.8744211,.5400681,.0713974,.5793762,.3326853,.1828673,48.34283
44175,35323,2425,3740,22022,25762,10698,5368,2460,13149,6225,2660,2451,857,200,1648,.6795876,.6553476,.2291444,.0534759,.4857869,.2437562,.1117065,45.77119
44176,13254,954,1264,7506,8770,3391,850,297,4265,950,325,874,100,28,555,.581761,.6914557,.0791139,.0221519,.4517719,.1132427,.0395683,58.68016
44177,17359,1174,1754,10517,12271,5196,2157,771,6359,2418,833,1163,261,62,739,.6294719,.6630559,.1488027,.0353478,.4940572,.2050965,.0733099,25.16898
44178,268215,20788,35833,143878,179711,84832,45532,20926,108078,54481,22804,23246,8949,1878,14193,.6827497,.6487316,.2497419,.0524098,.5896106,.3164625,.1454427,36.73696
44179,9588,674,1311,5346,6657,3557,1654,731,4376,1843,772,819,189,41,352,.5222552,.624714,.1441648,.0312738,.6653573,.3093902,.1367377,11.38455
44180,2283,296,214,1127,1341,716,349,168,842,399,187,126,50,19,259,.875,.5887851,.2336449,.088785,.635315,.3096717,.1490683,20.86285
44181,83838,6792,10346,46258,56604,28786,10993,4166,35975,12724,4447,7189,1731,281,4478,.659305,.6948579,.167311,.0271603,.6222923,.2376454,.0900601,23.71304
44182,24062,1616,2680,14810,17490,7985,3602,1426,9591,4076,1478,1606,474,52,975,.6033416,.5992537,.1768657,.019403,.5391628,.243214,.0962863,32.8717
44183,20724,1521,2289,12489,14778,6527,2826,1182,8023,3257,1241,1496,431,59,1079,.7094017,.6535605,.1882918,.0257754,.5226199,.2262791,.0946433,44.86565
44184,44609,3283,4818,26797,31615,15900,7540,3072,19131,8504,3180,3231,964,108,2233,.6801706,.6706102,.200083,.0224159,.59335,.2813748,.1146397,28.93973
44185,11038,878,1226,5830,7056,3014,1323,553,3710,1542,598,696,219,45,593,.6753986,.5676998,.1786297,.0367047,.5169811,.2269297,.0948542,25.35267
44186,14618,1216,1816,7401,9217,3645,1485,689,4627,1752,748,982,267,59,750,.6167763,.5407489,.1470264,.032489,.492501,.2006486,.0930955,29.55596
44187,24407,1623,2225,15163,17388,6968,2932,1378,8178,3273,1395,1210,341,17,1048,.6457178,.5438202,.1532584,.0076404,.4595397,.1933654,.0908791,55.85077
44188,98637,7102,14056,56203,70259,33770,15508,5807,42826,18497,6344,9056,2989,537,4269,.6010983,.64428,.2126494,.0382043,.6008576,.2759283,.1033219,18.05331
44189,5188,411,460,2869,3329,1179,629,350,1426,725,359,247,96,9,302,.7347932,.5369565,.2086957,.0195652,.4109446,.2192402,.1219937,52.88383
44190,4839,298,429,3183,3612,1360,401,158,1611,467,164,251,66,6,188,.6308725,.5850816,.1538462,.013986,.4272699,.1259818,.0496387,53.03127
44191,75062,6089,11206,42227,53433,34504,21051,10178,44059,25964,11027,9555,4913,849,4886,.8024306,.8526682,.4384258,.075763,.8171076,.4985199,.2410306,8.414063
44192,4135,260,539,2065,2604,1137,445,188,1442,510,200,305,65,12,131,.5038462,.5658627,.1205937,.0222635,.5506053,.2154964,.0910412,18.70757
44193,2469,206,190,1508,1698,707,347,119,792,385,119,85,38,0,167,.8106796,.4473684,.2,0,.4688329,.2301061,.0789125,57.10117
44194,16101,1044,1495,10149,11644,4425,1916,905,5404,2099,932,979,183,27,754,.7222222,.6548495,.122408,.0180602,.4360035,.1887871,.0891714,57.46837
44195,15801,1209,1912,7925,9837,3529,1548,686,4468,1740,717,939,192,31,658,.5442514,.4911088,.1004184,.0162134,.4452997,.1953312,.0865615,38.12636
44196,9289,742,1116,5325,6441,2322,1154,504,2961,1429,566,639,275,62,576,.7762803,.5725806,.2464158,.0555556,.4360563,.2167136,.0946479,41.3426
44197,1187,82,93,700,793,451,215,99,513,248,103,62,33,4,66,.8048781,.6666667,.3548387,.0430108,.6442857,.3071429,.1414286,18.66197
44198,14653,1046,1328,8952,10280,3585,1507,638,4385,1665,647,800,158,9,764,.7304015,.6024097,.1189759,.0067771,.4004692,.1683423,.071269,59.42214
44199,14528,1008,1298,8618,9916,6058,3255,1572,6975,3560,1616,917,305,44,775,.7688492,.7064715,.2349769,.0338983,.7029473,.3776979,.1824089,41.57676
44200,11872,792,1069,7462,8531,3148,1305,674,3760,1434,693,612,129,19,546,.6893939,.5724977,.1206735,.0177736,.4218708,.1748861,.0903243,37.00165
44201,41382,2656,4382,25423,29805,13505,6305,2377,16384,7275,2474,2879,970,97,1893,.7127259,.6570059,.2213601,.022136,.5312119,.2480038,.093498,42.0497
44202,8702,564,844,5593,6437,2331,873,407,2804,993,431,473,120,24,355,.6294326,.5604265,.1421801,.028436,.416771,.156088,.0727695,57.11794
44203,8785,715,821,5483,6304,2096,894,442,2669,1065,449,573,171,7,455,.6363636,.6979294,.2082826,.0085262,.3822725,.1630494,.0806128,65.57289
44204,11434,836,1083,6887,7970,3024,1008,433,3655,1131,443,631,123,10,469,.5610048,.5826408,.1135734,.0092336,.4390881,.1463627,.0628721,65.79697
44205,58013,4545,6696,30272,36968,15619,7458,3289,19424,8690,3449,3805,1232,160,3247,.7144114,.5682497,.1839904,.0238949,.5159553,.2463663,.1086483,52.36835
44206,6204,361,433,4106,4539,2039,958,457,2320,1032,469,281,74,12,254,.7036011,.6489607,.1709007,.0277136,.4965903,.2333171,.1113005,42.58212
44207,2820,180,320,1619,1939,886,517,225,1055,566,238,169,49,13,102,.5666667,.528125,.153125,.040625,.5472514,.3193329,.1389747,30.67199
44208,18192,1445,2334,10368,12702,5752,2669,1041,7192,3219,1091,1440,550,50,956,.6615917,.6169666,.235647,.0214225,.5547839,.2574267,.1004051,21.14851
44209,3915,254,417,2427,2844,1254,637,262,1530,735,276,276,98,14,134,.527559,.6618705,.235012,.0335731,.5166873,.262464,.1079522,24.41775
44210,23084,1713,2282,14279,16561,6279,2507,1076,7658,2868,1137,1379,361,61,1084,.6328079,.6042945,.1581946,.0267309,.4397367,.1755725,.0753554,54.4879
44211,3174,244,301,1893,2194,1218,545,170,1410,625,206,192,80,36,182,.7459016,.6378738,.2657807,.1196013,.6434231,.2879028,.0898045,13.69706
44212,128366,9379,16186,75044,91230,48888,27617,12052,60681,32810,12882,11793,5193,830,6978,.7440026,.7285926,.3208328,.0512789,.6514578,.3680108,.1605991,32.62888
44213,4154,306,481,2440,2921,1250,567,225,1549,642,235,299,75,10,163,.5326797,.6216216,.1559252,.02079,.5122951,.2323771,.0922131,45.80897
44214,27266,2470,3190,12693,15883,3382,1376,759,4927,1870,869,1545,494,110,1609,.651417,.484326,.1548589,.0344828,.2664461,.1084062,.0597967,80.71004
44215,9926,601,916,6250,7166,3251,1653,583,3839,1821,626,588,168,43,343,.5707155,.6419214,.1834061,.0469432,.52016,.26448,.09328,25.05256
44216,1206,94,130,698,828,372,178,77,453,204,79,81,26,2,66,.7021276,.6230769,.2,.0153846,.5329513,.2550143,.1103152,23.83178
44217,2406,154,219,1589,1808,767,286,127,930,352,132,163,66,5,101,.6558442,.7442923,.3013699,.0228311,.4826935,.1799874,.0799245,28.92071
44218,5130,405,689,2775,3464,1625,707,282,2007,807,307,382,100,25,215,.5308642,.5544267,.1451379,.0362845,.5855856,.2547748,.1016216,33.01047
44219,9723,787,1059,5468,6527,2734,1376,661,3270,1548,700,536,172,39,558,.7090216,.5061378,.1624174,.0368272,.5,.251646,.1208851,27.31783
44220,860880,63158,120686,493027,613713,343299,190596,90523,431865,229030,99071,88566,38434,8548,42077,.666218,.7338548,.3184628,.0708284,.6963087,.3865833,.1836066,19.88344
44221,110932,9561,20007,60132,80139,38808,20701,10472,54369,27516,11642,15561,6815,1170,6306,.6595544,.7777778,.3406308,.0584795,.6453801,.3442593,.1741502,20.43288
44222,1595,106,140,953,1093,571,279,109,663,313,114,92,34,5,82,.7735849,.6571429,.2428571,.0357143,.5991606,.2927597,.1143757,42.70872
44223,14581,1127,1643,7865,9508,3836,1599,711,4755,1845,784,919,246,73,764,.6779059,.5593427,.1497261,.0444309,.4877304,.2033058,.0904005,28.63639
44224,2053,118,170,1413,1583,709,350,168,812,388,175,103,38,7,84,.7118644,.6058823,.2235294,.0411765,.5017693,.2476999,.118896,22.18638
44225,21442,1536,2363,12717,15080,6724,2776,1229,8258,3211,1300,1534,435,71,1026,.6679688,.6491747,.184088,.0300466,.5287411,.2182905,.0966423,37.14758
44226,84784,7272,13622,48027,61649,28720,15272,7069,39070,19834,7761,10350,4562,692,4740,.6518152,.7598003,.3348994,.0508002,.597997,.3179878,.147188,30.13602
44227,419573,34306,84862,227453,312315,171536,113546,68585,241998,155975,78504,70462,42429,9919,25564,.7451758,.8303127,.4999764,.1168839,.7541602,.4992064,.3015348,29.30917
44228,9450,566,786,6131,6917,2757,1072,516,3269,1243,566,512,171,50,410,.7243816,.6513995,.2175573,.0636132,.4496819,.1748491,.0841625,55.34774
44229,16223,1042,1524,10064,11588,5010,1878,943,5955,2003,946,945,125,3,616,.5911708,.6200787,.082021,.0019685,.497814,.1866057,.0937003,54.62051
44230,28595,1980,2974,17037,20011,9192,3884,1698,11112,4441,1775,1920,557,77,1406,.710101,.6455951,.1872898,.0258911,.5395316,.2279744,.0996654,41.77653
44231,4619,340,557,2426,2983,1284,595,258,1609,675,289,325,80,31,191,.5617647,.5834829,.1436266,.0556553,.5292663,.2452597,.1063479,21.6425
44232,22441,1877,2738,11968,14706,5595,3255,1590,7117,3852,1684,1522,597,94,1319,.7027171,.5558802,.2180424,.0343316,.4674967,.2719753,.1328543,46.72184
44233,35910,2752,4760,17668,22428,9026,4324,2162,12189,5314,2488,3163,990,326,1619,.5882994,.6644958,.2079832,.0684874,.5108671,.2447362,.1223681,44.18505
44234,31426,1999,2658,20179,22837,9953,3869,1663,11488,4282,1709,1535,413,46,1465,.7328664,.5775019,.15538,.0173062,.4932355,.191734,.0824124,40.89387
44235,68807,5364,9220,37304,46524,21803,10586,4472,27941,12757,4910,6138,2171,438,3677,.6854959,.6657267,.2354664,.0475054,.5844681,.2837766,.1198799,35.92762
44236,41789,4101,10621,23566,34187,14324,8436,4170,23126,13922,4822,8802,5486,652,3372,.8222385,.8287355,.5165238,.0613878,.6078249,.3579733,.1769498,53.43881
44237,19798,2498,4508,9980,14488,5799,3069,1628,9751,5587,1885,3952,2518,257,2096,.8390713,.8766637,.5585626,.0570098,.5810621,.307515,.1631262,49.35139
44238,13976,1045,1705,7558,9263,4397,1647,634,5432,1990,717,1035,343,83,535,.5119617,.6070381,.201173,.0486804,.5817677,.2179148,.0838846,20.44869
44239,21998,1937,2956,13373,16329,6455,3487,1509,8647,4303,1627,2192,816,118,1397,.7212184,.7415426,.2760487,.0399188,.482689,.2607493,.1128393,51.8071
44240,99258,8849,12920,47166,60086,19567,10509,4645,26825,13719,5181,7258,3210,536,6263,.7077636,.5617647,.248452,.0414861,.4148539,.2228088,.098482,60.02448
44241,40242,3096,4729,22923,27652,11061,5675,2472,14238,6823,2645,3177,1148,173,2346,.7577519,.6718122,.2427575,.0365828,.4825285,.247568,.1078393,45.16455
44242,7137,496,733,4430,5163,2419,1037,473,2864,1172,512,445,135,39,310,.625,.6070941,.1841746,.053206,.5460497,.2340858,.106772,26.80755
44243,121082,10698,19507,68801,88308,44979,22683,9886,60175,27631,10871,15196,4948,985,5779,.5401945,.7790024,.2536525,.0504947,.653755,.32969,.1436898,20.79062
44244,15931,1115,1625,10076,11701,5062,2428,1100,5956,2751,1170,894,323,70,793,.7112108,.5501539,.1987692,.0430769,.5023819,.2409686,.1091703,31.7923
44245,17495,1563,2123,8676,10799,2916,1389,770,3677,1554,820,761,165,50,1053,.6737044,.358455,.0777202,.0235516,.3360996,.1600968,.0887506,63.82624
44246,76521,5533,7862,43356,51218,28389,15717,8429,34174,17761,8793,5785,2044,364,4191,.7574553,.7358178,.2599847,.0462987,.6547883,.3625104,.1944137,45.56001
44247,16756,1351,1882,9571,11453,4328,1584,629,5551,1794,681,1223,210,52,859,.6358253,.6498406,.1115834,.0276302,.4521993,.1654999,.0657194,53.17091
44248,9944,725,1179,5466,6645,2894,1002,420,3481,1139,458,587,137,38,369,.5089655,.4978796,.1162002,.0322307,.5294548,.183315,.0768386,14.27662
44249,26575,1932,2728,16030,18758,8354,3245,1205,10138,3657,1295,1784,412,90,1222,.6325052,.6539589,.1510264,.0329912,.5211478,.2024329,.0751716,29.69477
44250,24697,1869,2700,15838,18538,8024,3421,1431,9913,4080,1484,1889,659,53,1478,.7907972,.6996296,.2440741,.0196296,.5066296,.2159995,.0903523,40.28643
44251,8299,680,1015,4371,5386,2266,968,386,2874,1072,399,608,104,13,425,.625,.5990148,.1024631,.0128079,.5184168,.2214596,.0883093,15.82936
44252,19083,1176,1972,12069,14041,6261,2740,1249,7415,3121,1340,1154,381,91,688,.585034,.5851927,.1932049,.046146,.5187671,.2270279,.1034883,23.24138
44253,6628,519,682,3688,4370,1524,600,267,1826,670,285,302,70,18,378,.7283237,.4428152,.1026393,.026393,.4132321,.1626898,.072397,75.67899
44254,11666,1061,1374,5606,6980,1452,758,419,1955,870,431,503,112,12,673,.6343073,.3660844,.0815138,.0087336,.2590082,.1352123,.0747413,75.8392
45001,4378,280,434,2382,2816,1811,741,205,2148,813,205,337,72,0,197,.7035714,.7764977,.1658986,0,.7602855,.3110831,.0860621,16.91028
45002,33222,2866,3687,16233,19920,12633,5990,2480,15162,6810,2548,2529,820,68,2094,.730635,.6859235,.222403,.0184432,.7782295,.3690014,.1527752,11.10762
45003,57176,5101,12102,25451,37553,21480,13344,6901,32431,19853,7693,10951,6509,792,4165,.8165066,.9048917,.537845,.0654437,.8439747,.5243016,.2711485,20.5874
45004,22179,1542,2873,11635,14508,7651,3521,1188,9782,4165,1251,2131,644,63,1036,.6718547,.7417334,.2241559,.0219283,.6575848,.3026214,.1021057,18.74643
45005,769,35,86,391,477,318,164,57,398,195,68,80,31,11,23,.6571429,.9302326,.3604651,.127907,.8132992,.4194373,.1457801,14.05361
45006,146540,12386,19126,66838,85964,57358,31344,13655,71823,35833,14080,14465,4489,425,7986,.6447602,.7563003,.2347067,.0222211,.8581645,.4689548,.2043,9.398367
45007,12565,962,1578,5623,7201,4206,1972,701,5250,2205,757,1044,233,56,535,.556133,.661597,.1476553,.035488,.7479993,.3507025,.1246665,28.19004
45008,11451,797,1445,5124,6569,3843,1574,504,4908,1788,530,1065,214,26,412,.5169385,.7370242,.1480969,.0179931,.75,.3071819,.0983607,32.06416
45009,3673,249,371,2020,2391,1464,695,268,1754,785,285,290,90,17,189,.7590361,.7816712,.2425876,.0458221,.7247525,.3440594,.1326733,31.29792
45010,8241,585,1052,4256,5308,3129,1432,685,3781,1622,742,652,190,57,320,.5470086,.6197718,.1806084,.0541825,.7351974,.3364662,.1609492,9.772549
45011,17349,1476,2846,7947,10793,6617,4009,1581,9202,5283,1708,2585,1274,127,1214,.8224932,.9082924,.4476458,.044624,.8326412,.5044671,.198943,18.72091
45012,5530,359,551,2875,3426,2143,827,339,2573,960,339,430,133,0,243,.6768802,.7803993,.2413793,0,.7453913,.2876522,.117913,36.79185
45013,4024,256,294,2162,2456,1751,925,317,1971,982,325,220,57,8,180,.703125,.7482993,.1938775,.0272109,.8098983,.4278446,.1466235,19.7894
45014,8970,590,775,4581,5356,3545,1737,657,4106,1940,675,561,203,18,410,.6949152,.723871,.2619355,.0232258,.7738485,.3791749,.1434185,36.49277
45015,4917,413,492,2357,2849,1964,974,378,2353,1106,387,389,132,9,337,.8159806,.7906504,.2682927,.0182927,.8332626,.4132372,.1603734,11.61867
45016,1329,84,74,763,837,564,259,92,619,273,92,55,14,0,66,.7857143,.7432432,.1891892,0,.7391874,.3394496,.1205767,37.14103
45017,2100,133,261,999,1260,759,361,131,967,433,137,208,72,6,79,.593985,.7969348,.2758621,.0229885,.7597598,.3613614,.1311311,33.18052
45018,619066,43756,84633,314739,399372,252880,141670,68191,317688,168942,72782,64808,27272,4591,28992,.6625834,.7657533,.3222384,.054246,.8034593,.450119,.2166589,13.0156
45019,12253,1030,1448,4995,6443,2939,1533,715,3813,1826,786,874,293,71,583,.5660194,.6035911,.2023481,.0490332,.5883884,.3069069,.1431431,34.22294
45020,14620,1326,1854,7194,9048,5340,2470,985,6907,3011,1011,1567,541,26,1046,.7888386,.8451996,.2918015,.0140237,.7422853,.3433417,.1369197,35.07348
45021,14727,982,1354,7569,8923,5856,2802,1005,6948,3196,1044,1092,394,39,695,.7077393,.8064992,.2909897,.0288035,.7736821,.3701942,.1327784,23.88838
45022,10198,725,1167,5424,6591,4549,2686,1366,5515,3102,1445,966,416,79,516,.7117242,.8277635,.3564696,.0676949,.83868,.4952065,.2518437,19.94604
45023,26033,1939,2892,12830,15722,9259,4061,1607,11259,4553,1683,2000,492,76,1262,.650851,.691563,.1701245,.0262794,.7216679,.3165238,.1252533,15.4812
45024,20506,1485,2636,9411,12047,6545,2989,1131,8339,3477,1266,1794,488,135,898,.6047138,.6805766,.185129,.051214,.6954628,.317607,.1201785,23.86573
45025,218106,20473,48172,88199,136371,72973,45556,20614,116322,71466,23133,43349,25910,2519,15478,.7560201,.8998796,.5378643,.0522918,.8273677,.5165138,.2337215,16.67482
45026,8523,587,901,4233,5134,3301,1530,652,3998,1713,665,697,183,13,431,.7342419,.7735849,.2031077,.0144284,.7798252,.3614458,.1540279,22.28505
45027,26065,2157,3225,12957,16182,10338,5342,1934,13042,6317,2003,2704,975,69,1701,.7885953,.8384496,.3023256,.0213953,.7978699,.4122868,.1492629,29.14634
45028,1911,112,155,1045,1200,749,331,135,870,375,137,121,44,2,72,.6428571,.7806451,.283871,.0129032,.7167464,.3167464,.1291866,35.71819
45029,144616,11017,20259,74557,94816,58007,29638,11628,73645,35183,12245,15638,5545,617,7572,.6873015,.7719039,.2737055,.0304556,.7780222,.3975213,.1559612,11.82035
46001,29406,2845,4922,15835,20757,11149,5595,3241,15412,7571,3411,4263,1976,170,2175,.7644991,.8661113,.4014628,.0345388,.7040733,.3533312,.2046732,30.64315
46002,33345,2495,3971,19985,23956,13637,6932,3678,16838,8209,3893,3201,1277,215,1841,.7378758,.8060942,.3215815,.0541425,.6823618,.3468601,.184038,19.68469
46003,25808,2048,3143,15060,18203,10280,4416,2247,12808,5327,2355,2528,911,108,1440,.703125,.8043271,.2898505,.0343621,.6826029,.2932271,.1492032,27.04745
46004,115534,12007,22599,61001,83600,47775,27066,16230,67952,38088,18159,20177,11022,1929,9675,.8057799,.8928271,.4877207,.0853578,.7831839,.4436976,.2660612,20.18015
46005,6313,451,656,3722,4378,2095,712,307,2569,796,323,474,84,16,280,.6208426,.722561,.1280488,.0243902,.5628694,.191295,.0824825,23.93454
46006,34788,2473,3770,19699,23469,11665,4046,1846,14534,4641,1984,2869,595,138,1671,.6756975,.761008,.1578249,.0366048,.592162,.2053911,.0937103,30.62358
46007,4613,291,463,2770,3233,1839,788,399,2201,863,419,362,75,20,188,.6460481,.7818574,.161987,.0431965,.6638989,.2844765,.1440433,36.82421
46008,16767,1350,2391,9525,11916,6861,3662,2128,8853,4547,2269,1992,885,141,946,.7007408,.8331242,.370138,.0589711,.720315,.3844619,.2234121,32.8176
46009,22739,1774,2690,13183,15873,9110,4305,2291,11339,5033,2444,2229,728,153,1385,.7807215,.8286245,.270632,.0568773,.6910415,.3265569,.1737844,28.51904
46010,23440,1642,2424,13638,16062,8191,3240,1529,9936,3629,1605,1745,389,76,1139,.6936663,.7198845,.1604785,.0313531,.6006013,.2375715,.1121132,30.1842
46011,58347,4678,7489,35006,42495,24502,11481,5770,30675,13771,6212,6173,2290,442,3436,.7345019,.8242756,.3057818,.0590199,.6999372,.3279724,.1648289,23.36523
46012,52393,4019,6627,30993,37620,22575,10718,6116,28068,13081,6468,5493,2363,352,3038,.7559094,.8288819,.3565716,.053116,.7283903,.34582,.1973349,19.82007
46013,36933,2358,3998,22835,26833,16445,8132,4501,19554,9218,4789,3109,1086,288,1516,.6429178,.7776388,.2716358,.072036,.7201664,.35612,.1971097,19.53598
46014,51030,3366,5257,31799,37056,23418,11152,5901,27459,12440,6392,4041,1288,491,2447,.7269756,.7686894,.2450067,.0933993,.7364383,.3507029,.1855719,18.90414
47001,31268,2071,3220,19655,22875,8090,3408,1580,10002,3961,1692,1912,553,112,1338,.6460647,.5937888,.1717391,.0347826,.4116001,.173391,.0803867,54.03124
47002,55783,6506,11654,30695,42349,21506,14596,10049,31454,19623,11601,9948,5027,1552,5631,.8655087,.8536125,.431354,.1331732,.7006353,.4755172,.3273823,33.85589
47003,14333,1122,1417,8536,9953,4265,1669,716,5258,1883,750,993,214,34,830,.7397504,.7007763,.1510233,.0239944,.4996485,.1955248,.08388,36.29948
47004,8405,617,944,4973,5917,2022,752,349,2487,890,377,465,138,28,407,.6596434,.4925847,.1461864,.029661,.4065956,.1512166,.070179,56.71544
47005,29122,2334,3957,17286,21243,7337,3412,1573,9789,4278,1645,2452,866,72,1559,.667952,.6196613,.2188527,.0181956,.4244475,.1973852,.0909985,33.1461
47006,11971,923,1310,7112,8422,3078,1231,518,4025,1381,532,947,150,14,642,.695558,.7229007,.1145038,.010687,.4327897,.1730877,.0728346,42.03419
47007,152599,7285,21175,106479,127654,92251,66259,45274,110749,77432,51178,18498,11173,5904,5156,.7077557,.8735774,.5276505,.2788194,.8663774,.6222729,.4251918,6.683162
47008,53732,4141,6234,32595,38829,16801,7104,3150,20931,8208,3345,4130,1104,195,2851,.688481,.662496,.1770934,.0312801,.5154471,.2179475,.0966406,30.09909
47009,5860,385,696,3679,4375,1751,668,323,2130,769,357,379,101,34,251,.651948,.5445402,.1451149,.0488506,.4759445,.1815711,.0877956,40.57999
47010,40918,2925,4217,25456,29673,12864,5616,2738,15700,6228,2869,2836,612,131,1940,.6632479,.672516,.1451269,.0310647,.5053425,.220616,.1075581,36.87615
47011,6349,406,724,3933,4657,1846,688,204,2353,795,204,507,107,0,254,.6256158,.7002763,.1477901,0,.4693618,.1749301,.0518688,56.89655
47012,23270,1561,2338,14394,16732,8306,3457,1562,9892,3836,1656,1586,379,94,1069,.6848174,.6783575,.1621044,.0402053,.577046,.2401695,.1085174,34.89237
47013,15632,1390,2113,8988,11101,3182,1477,714,4581,2074,769,1399,597,55,1067,.7676259,.6620918,.2825367,.0260293,.3540276,.1643302,.0794393,60.24159
47014,37989,3188,5142,19656,24798,6559,2000,999,9210,2512,1071,2651,512,72,1779,.5580301,.5155581,.0995722,.0140023,.3336895,.1017501,.0508242,59.08647
47015,11751,895,1352,6865,8217,2454,949,460,3156,1082,477,702,133,17,594,.6636872,.5192308,.0983728,.012574,.3574654,.1382374,.0670066,64.33299
47016,45424,3374,5166,26355,31521,13401,5862,2547,16962,7001,2722,3561,1139,175,2565,.7602252,.6893147,.2204801,.0338753,.5084804,.2224246,.096642,31.46319
47017,17904,1375,2251,10086,12337,4321,1393,635,5581,1751,693,1260,358,58,983,.7149091,.5597512,.1590404,.0257663,.4284156,.1381122,.0629586,45.82255
47018,27270,1838,2782,17077,19859,6359,2295,994,7937,2521,1052,1578,226,58,1147,.6240479,.5672178,.0812365,.0208483,.3723722,.1343913,.0582069,47.09932
47019,6692,630,936,3668,4604,1538,580,307,2126,739,351,588,159,44,432,.6857143,.6282051,.1698718,.0470085,.4193021,.1581243,.0836968,54.63282
47020,12266,906,1296,7280,8576,2611,1003,485,3329,1245,515,718,242,30,612,.6754967,.5540124,.1867284,.0231481,.3586538,.1377747,.0666209,49.81379
47021,141372,10839,16353,79664,96017,58164,33198,18611,70459,38436,19782,12295,5238,1171,8271,.7630778,.7518498,.3203082,.0716077,.7301165,.4167252,.2336187,12.63327
47022,9965,584,878,6376,7254,3655,1801,1000,4234,1947,1067,579,146,67,391,.6695206,.6594533,.166287,.0763098,.5732434,.2824655,.1568381,39.88524
47023,3948,255,414,2489,2903,1239,401,207,1537,443,207,298,42,0,179,.7019608,.7198068,.1014493,0,.4977903,.1611089,.0831659,43.87023
47024,22620,1599,2464,13513,15977,6768,3019,1537,8367,3359,1618,1599,340,81,1058,.6616635,.6489448,.137987,.0328734,.500851,.2234145,.1137423,42.44987
47025,7881,654,786,4547,5333,1790,678,329,2211,806,352,421,128,23,416,.6360856,.5356234,.1628499,.0292621,.3936661,.1491093,.0723554,63.7226
47026,19806,1517,2408,10897,13305,3650,1051,492,5010,1272,536,1360,221,44,976,.6433751,.564784,.0917774,.0182724,.3349546,.0964486,.04515,55.95617
47027,22602,2011,2855,13265,16120,5291,2035,880,6953,2485,916,1662,450,36,1269,.6310294,.5821366,.1576182,.0126095,.3988692,.1534112,.06634,46.68024
47028,8864,633,931,5469,6400,2536,1292,659,3089,1415,686,553,123,27,441,.6966825,.593985,.132116,.0290011,.4637045,.2362406,.1204973,46.89441
47029,596901,42500,65353,356320,421673,315337,222512,148863,367685,247222,156645,52348,24710,7782,34276,.8064941,.8010038,.3781005,.1190764,.8849826,.6244724,.417779,6.992537
47030,35889,2689,4097,21025,25122,12688,6200,3256,15586,7024,3412,2898,824,156,1753,.6519152,.7073469,.2011228,.0380766,.6034721,.294887,.1548633,38.75288
47031,11563,677,1195,7335,8530,2945,1231,556,3725,1384,577,780,153,21,411,.6070901,.6527197,.1280335,.0175732,.4014997,.1678255,.075801,42.03131
47032,10244,769,1143,6039,7182,3126,1275,681,3851,1458,724,725,183,43,491,.6384916,.6342957,.160105,.0376203,.5176353,.2111277,.112767,51.58338
47033,35740,3319,4963,20943,25906,9546,3569,1546,13170,4789,1689,3624,1220,143,2330,.7020187,.7302035,.2458191,.0288132,.4558086,.1704149,.0738194,40.65594
47034,34150,2454,3666,19849,23515,10605,3982,1962,12903,4494,2094,2298,512,132,1591,.6483293,.6268412,.1396618,.0360065,.5342838,.2006146,.0988463,32.69775
47035,17810,1286,1795,10952,12747,5763,1921,792,7021,2229,832,1258,308,40,966,.7511664,.7008356,.1715878,.0222841,.5262052,.1754017,.0723156,38.38632
47036,20107,1479,2189,12380,14569,6949,3265,1633,8408,3804,1738,1459,539,105,1047,.7079108,.6665144,.2462312,.0479671,.5613086,.2637318,.1319063,42.31647
47037,11761,920,1358,7224,8582,3401,1651,967,4250,1885,1039,849,234,72,549,.5967391,.6251841,.1723122,.0530191,.4707918,.2285437,.1338594,49.92769
47038,16579,1101,1715,10424,12139,3988,1396,509,4933,1572,530,945,176,21,751,.6821072,.5510204,.1026239,.0122449,.3825787,.1339217,.0488296,47.02851
47039,7625,509,725,4535,5260,2231,867,472,2711,1007,518,480,140,46,322,.6326129,.662069,.1931034,.0634483,.4919515,.1911797,.1040794,57.66074
47040,15743,1171,1746,9118,10864,3077,1326,554,4078,1609,625,1001,283,71,780,.6660973,.5733104,.1620848,.0406644,.3374644,.1454266,.0607589,56.42788
47041,30599,2395,3280,18328,21608,6653,2171,925,8509,2594,1005,1856,423,80,1760,.7348643,.5658537,.1289634,.0243902,.3629965,.1184526,.0504692,53.22244
47042,50398,4150,5817,30026,35843,17935,8234,3740,22195,9723,3897,4260,1489,157,3200,.7710843,.7323363,.2559739,.0269899,.5973157,.274229,.1245587,28.04757
47043,180735,11593,22112,111928,134040,77560,42608,23326,94502,50078,25887,16942,7470,2561,8525,.7353575,.7661903,.3378256,.1158195,.6929455,.3806733,.2084018,8.038089
47044,57654,4344,6812,33729,40541,14654,5154,2100,18698,6400,2316,4044,1246,216,2831,.6517035,.5936583,.1829125,.0317088,.4344629,.1528062,.062261,31.51145
47045,2937,175,347,1902,2249,1013,412,167,1262,487,181,249,75,14,110,.6285715,.7175792,.2161383,.0403458,.5325972,.2166141,.0878023,57.94304
47046,21603,1679,2567,12626,15193,6061,2590,1177,7721,3160,1338,1660,570,161,1312,.7814175,.6466693,.2220491,.0627191,.4800412,.2051323,.0932203,44.78992
47047,22763,1699,2850,13540,16390,8706,4896,3167,10730,5768,3418,2024,872,251,1157,.6809888,.7101755,.3059649,.0880702,.6429837,.3615953,.2338996,32.09426
47048,5968,433,636,3680,4316,1567,544,278,1928,639,291,361,95,13,277,.6397229,.5676101,.1493711,.0204403,.4258152,.1478261,.0755435,45.56483
47049,10543,785,1011,6024,7035,3805,1847,1155,4380,1998,1237,575,151,82,585,.7452229,.5687438,.1493571,.0811078,.6316401,.3066069,.1917331,28.06872
47050,9334,700,957,5583,6540,2947,1335,694,3559,1511,728,612,176,34,543,.7757143,.6394984,.183908,.0355277,.5278524,.2391188,.1243059,41.2984
47051,10129,683,942,6899,7841,3494,1841,986,4050,1995,1032,556,154,46,443,.6486091,.5902336,.163482,.0488323,.5064502,.2668503,.1429193,45.52505
47052,25956,1779,2788,15323,18111,5253,2039,952,6697,2336,1023,1444,297,71,1035,.5817875,.517934,.106528,.0254663,.342818,.1330679,.0621288,67.34709
47053,57427,4269,5467,33104,38571,24936,13717,7773,29076,15050,8129,4140,1333,356,3114,.7294449,.7572709,.2438266,.065118,.7532625,.4143608,.2348055,33.3401
47054,17825,1425,2044,10587,12631,4335,1594,760,5513,1805,807,1178,211,47,830,.5824561,.5763209,.103229,.0229941,.4094644,.150562,.0717862,50.45458
47055,12124,915,1280,7390,8670,2911,1137,499,3528,1345,545,617,208,46,685,.7486339,.4820313,.1625,.0359375,.3939107,.1538566,.0675237,49.27832
47056,10232,817,1075,6240,7315,2835,1128,619,3436,1245,654,601,117,35,600,.7343941,.5590698,.1088372,.0325581,.4543269,.1807692,.0991987,51.9589
47057,7995,492,765,5477,6242,2945,1308,576,3440,1408,597,495,100,21,373,.7581301,.6470588,.130719,.027451,.5377031,.2388169,.1051671,40.55208
47058,29444,2066,3168,18102,21270,7436,3380,1539,9274,3788,1656,1838,408,117,1361,.6587609,.5801768,.1287879,.0369318,.4107834,.1867197,.0850182,55.21376
47059,7719,541,699,5208,5907,2616,1330,551,3110,1482,584,494,152,33,366,.6765249,.7067239,.2174535,.0472103,.5023041,.2553763,.1057988,54.58148
47060,63516,8713,21945,28802,50747,17844,11523,7726,38161,25946,9700,20317,14423,1974,7616,.8740962,.9258145,.657234,.0899522,.6195403,.4000764,.2682452,33.08435
47062,12204,899,1262,7613,8875,2785,1439,772,3403,1615,815,618,176,43,505,.5617353,.4896989,.1394612,.0340729,.3658216,.1890188,.1014055,49.04665
47063,8781,556,900,5211,6111,2862,1145,475,3450,1286,520,588,141,45,419,.7535971,.6533333,.1566667,.05,.5492228,.2197275,.0911533,43.9313
47064,14625,1121,1708,8947,10655,3574,1752,778,4568,1992,806,994,240,28,659,.587868,.5819672,.1405152,.0163934,.3994635,.1958198,.0869565,25.85622
47065,9828,605,909,6680,7589,3131,1541,703,3699,1713,729,568,172,26,490,.8099173,.6248625,.1892189,.0286029,.4687126,.2306886,.1052395,59.13069
47066,14666,1015,1462,9194,10656,3573,1721,807,4463,1967,858,890,246,51,728,.7172414,.6087551,.1682627,.0348837,.388623,.1871873,.0877746,50.07981
47067,18063,1273,1927,11052,12979,5565,2475,1243,6703,2749,1311,1138,274,68,778,.6111547,.5905553,.1421899,.035288,.5035288,.2239414,.1124683,44.40244
47068,19401,1329,2019,11997,14016,4905,1616,728,5948,1848,763,1043,232,35,703,.5289692,.5165924,.1149084,.0173353,.4088522,.1347003,.0606818,41.08028
47069,17647,1161,1753,10976,12729,4371,1451,655,5423,1692,710,1052,241,55,799,.6881998,.6001141,.1374786,.0313748,.3982325,.1321975,.0596757,40.2383
47070,66147,5130,7945,39004,46949,14746,5578,2218,19465,6808,2393,4719,1230,175,3613,.7042885,.5939584,.1548143,.0220264,.3780638,.143011,.056866,44.28129
47071,13062,1136,1481,7688,9169,4015,1533,679,4795,1728,694,780,195,15,818,.7200704,.5266712,.1316678,.0101283,.5222424,.1994017,.0883195,46.71014
47072,16456,2186,4059,8456,12515,3944,2147,1278,7489,4106,1370,3545,1959,92,1937,.8860933,.8733678,.4826312,.0226657,.4664144,.2539026,.1511353,44.02516
47073,25733,3123,5375,12531,17906,8514,4051,1834,12293,4847,1984,3779,796,150,1198,.3836055,.7030697,.148093,.027907,.679435,.3232783,.146357,46.5012
47074,166665,12658,20304,86450,106754,69864,35797,19315,85242,40151,20397,15378,4354,1082,8622,.6811503,.7573877,.2144405,.05329,.8081434,.4140775,.2234239,28.59533
47075,35229,2284,3808,21268,25076,9933,4594,1876,12420,5321,2038,2487,727,162,1456,.6374781,.6530988,.1909139,.042542,.4670397,.2160053,.0882076,20.13302
47076,6093,386,587,3874,4461,1808,805,433,2203,872,437,395,67,4,280,.7253886,.6729131,.1141397,.0068143,.4667011,.2077956,.1117708,26.41939
47077,6952,529,700,4360,5060,1866,897,397,2297,1062,416,431,165,19,391,.7391304,.6157143,.2357143,.0271429,.4279816,.2057339,.091055,35.76333
47078,96903,7082,11178,60230,71408,40854,21074,10290,49938,25254,11204,9084,4180,914,5795,.8182717,.8126677,.3739488,.0817678,.6782998,.3498921,.1708451,52.98991
47079,25203,2628,4774,14418,19192,7624,3777,2335,11547,6081,2720,3923,2304,385,2132,.8112633,.8217428,.4826142,.0806452,.5287834,.2619642,.1619503,46.89524
47080,57038,4760,8658,32985,41643,17471,7292,3872,23886,10238,4378,6415,2946,506,3172,.6663865,.7409332,.3402633,.0584431,.529665,.2210702,.1173867,20.34223
47081,31761,2276,3757,18347,22104,7166,2726,1080,9386,3237,1159,2220,511,79,1598,.702109,.590897,.1360128,.0210274,.3905816,.1485801,.0588652,35.91323
47082,25068,1658,2635,15497,18132,5680,1668,766,7277,1875,806,1597,207,40,1123,.6773221,.6060721,.0785579,.0151803,.3665226,.1076337,.0494289,31.60298
47083,27559,1832,2819,17477,20296,8724,3075,1562,10784,3550,1667,2060,475,105,1223,.6675764,.7307556,.1684995,.0372473,.4991703,.1759455,.0893746,50.18866
47084,33366,2516,3787,20506,24293,7677,3463,1502,9901,4098,1572,2224,635,70,1591,.6323529,.5872722,.1676789,.0184843,.3743782,.1688774,.0732469,51.50638
47085,18731,1658,2723,10806,13529,4169,2221,951,5589,2730,1060,1420,509,109,1179,.7110977,.5214837,.1869262,.0400294,.3858042,.205534,.0880067,33.29964
47086,34435,2443,3459,18914,22373,11011,5074,2449,13125,5612,2618,2114,538,169,1660,.6794924,.6111593,.1555363,.0488581,.5821614,.2682669,.1294808,36.49669
47087,40470,3205,4896,22174,27070,14448,6380,3334,18057,7350,3651,3609,970,317,2021,.6305772,.7371324,.1981209,.0647467,.6515739,.2877244,.1503563,54.50296
47088,6046,531,699,3491,4190,1380,659,251,1791,785,276,411,126,25,387,.7288136,.5879828,.1802575,.0357654,.3953022,.1887711,.0718992,33.63681
47089,10874,867,1179,6357,7536,2360,1039,516,3051,1240,557,691,201,41,586,.6758939,.5860899,.1704835,.0347752,.3712443,.1634419,.0811704,24.93645
47090,50511,3505,5892,29248,35140,12830,5326,2216,16677,6410,2376,3847,1084,160,2380,.6790299,.6529192,.1839783,.0271555,.4386625,.1820979,.0757659,54.39098
47091,21200,1515,2290,13118,15408,7089,2641,1234,8697,3016,1349,1608,375,115,891,.5881188,.7021834,.1637555,.0502183,.5404025,.2013264,.0940692,63.35908
47092,46487,3527,5486,27856,33342,12345,6101,2713,16081,7587,2936,3736,1486,223,2448,.6940743,.6810062,.2708713,.0406489,.443172,.2190192,.0973937,45.83324
47093,14041,949,1412,8818,10230,3923,1554,777,4763,1781,807,840,227,30,645,.6796628,.5949008,.1607649,.0212465,.4448855,.1762304,.0881152,26.43507
47094,43863,3208,5630,24693,30323,10080,3937,1858,13496,5037,2035,3416,1100,177,2078,.6477556,.6067495,.1953819,.0314387,.4082128,.1594379,.075244,43.95544
47095,25522,1827,2659,15553,18212,7043,3163,1330,8696,3644,1394,1653,481,64,1266,.6929392,.6216623,.1808951,.0240692,.4528387,.2033691,.085514,54.16515
47096,44189,3916,5377,24564,29941,18308,9980,5260,22221,11287,5589,3913,1307,329,2901,.7408069,.7277292,.2430723,.0611865,.7453184,.4062856,.2141345,49.17178
47097,103217,5004,13816,70552,84368,58564,42235,28885,69879,48733,31964,11315,6498,3079,3301,.6596723,.818978,.4703242,.2228575,.8300828,.5986364,.4094143,48.45693
47098,19042,1433,2442,11910,14352,6072,3032,1161,7954,3874,1276,1882,842,115,1057,.7376134,.7706798,.3447993,.0470925,.5098237,.254576,.0974811,24.51421
47099,6717,568,894,3951,4845,1713,638,279,2434,826,297,721,188,18,383,.6742958,.8064877,.2102908,.0201342,.4335611,.1614781,.070615,12.30682
47100,39916,3078,10244,21999,32243,14329,9633,6809,23274,17355,8740,8945,7722,1931,2482,.8063678,.873194,.7538071,.1885006,.6513478,.4378835,.3095141,33.9984
47101,114486,9103,14392,63671,78063,38663,16963,7322,48565,19967,7822,9902,3004,500,6552,.7197627,.6880211,.2087271,.0347415,.6072309,.2664164,.1149974,28.88637
47103,16509,1217,1849,10209,12058,6839,3309,1648,8124,3700,1701,1285,391,53,937,.7699261,.6949703,.2114657,.0286641,.6698991,.3241258,.1614262,27.46656
47104,9063,605,998,5837,6835,2833,935,299,3455,1084,322,622,149,23,402,.6644628,.6232465,.1492986,.0230461,.4853521,.160185,.0512249,8.292171
47105,45642,3063,5403,29113,34516,13826,6809,3057,17569,8545,3401,3743,1736,344,2249,.7342474,.6927633,.321303,.0636683,.4749081,.2338818,.1050046,19.17772
47106,19390,1604,2979,11495,14474,9845,6262,3849,12239,7512,4118,2394,1250,269,1170,.7294264,.8036254,.4196039,.0902988,.8564593,.5447586,.3348412,28.12083
47107,9515,497,990,6758,7748,5820,4260,3037,6699,4764,3195,879,504,158,361,.7263582,.8878788,.5090909,.159596,.8612015,.630364,.4493933,5.341246
47108,7308,554,858,4293,5151,1786,1014,465,2292,1215,521,506,201,56,390,.7039711,.5897436,.2342657,.0652681,.4160261,.2361985,.1083159,24.24294
47109,15322,1499,3501,8854,12355,5269,3151,1967,8238,4803,2247,2969,1652,280,1203,.802535,.8480434,.4718652,.0799771,.5950983,.3558843,.2221595,34.79095
47110,6524,380,668,4333,5001,1656,713,327,2087,842,385,431,129,58,185,.4868421,.6452096,.1931138,.0868263,.3821833,.1645511,.0754673,17.24076
47111,122617,10852,19825,67122,86947,45296,22694,10340,60618,28353,11115,15322,5659,775,8056,.7423517,.7728626,.2854477,.0390921,.6748309,.3381008,.1540478,25.42261
47112,19671,3084,7465,9034,16499,5733,3452,2101,12714,8428,2544,6981,4976,443,2842,.9215305,.9351641,.6665773,.0593436,.6346026,.382112,.2325659,19.76463
47113,23397,1637,3019,13598,16617,7457,2865,1343,9588,3413,1458,2131,548,115,1101,.6725718,.7058629,.1815171,.0380921,.5483895,.2106927,.0987645,22.65786
47114,66743,5720,10925,39658,50583,23347,13381,7429,32279,18253,8218,8932,4872,789,4438,.7758741,.8175744,.4459496,.0722197,.5887085,.3374099,.1873266,29.54217
47115,18149,1394,1866,11662,13528,6180,3356,1753,7225,3728,1822,1045,372,69,1041,.7467719,.5600215,.1993569,.0369775,.5299262,.2877722,.1503173,25.08289
47116,144903,11010,23230,80613,103843,54050,26636,13098,71303,31795,14008,17253,5159,910,6681,.606812,.7427034,.2220835,.0391735,.6704874,.3304182,.16248,31.73189
47117,266979,24059,64823,136685,201508,84386,38736,17058,133288,51837,19410,48902,13101,2352,11499,.47795,.7543927,.2021042,.0362834,.6173757,.2833961,.1247979,40.51466
47118,4757,378,578,2806,3384,1295,553,293,1553,618,293,258,65,0,205,.5423281,.4463668,.1124567,0,.461511,.1970777,.1044191,35.17869
47119,41055,3047,5455,24139,29594,12246,6411,3071,16031,8110,3378,3785,1699,307,2156,.7075812,.6938589,.3114574,.0562786,.5073118,.2655868,.1272215,31.43693
47120,104577,7819,14630,60131,74761,32814,15381,5974,42038,18881,6578,9224,3500,604,5217,.6672209,.6304853,.2392344,.041285,.5457085,.2557915,.0993498,22.24682
47121,13225,2092,4771,6014,10785,3675,2422,1277,8210,5603,1564,4535,3181,287,1928,.9216061,.9505345,.6667365,.0601551,.6110741,.402727,.2123379,28.89257
47122,219214,15470,34935,135350,170285,77324,46452,26770,103188,60752,30672,25864,14300,3902,11312,.7312217,.7403464,.4093316,.1116931,.5712892,.3431991,.1977835,25.09433
47123,100220,6213,11974,63844,75818,36690,17323,8008,44895,20274,8695,8205,2951,687,3856,.6206341,.6852347,.2464506,.0573743,.5746821,.2713332,.1254307,30.16451
47124,7093,437,637,4514,5151,2218,1173,604,2664,1350,654,446,177,50,340,.7780321,.700157,.277865,.0784929,.4913602,.2598582,.1338059,20.32512
47125,21857,1700,2835,14074,16909,8178,4451,2317,10297,5423,2506,2119,972,189,1345,.7911765,.7474427,.3428572,.0666667,.5810715,.3162569,.1646298,26.15723
47126,47621,3726,5379,28087,33466,13132,6168,2784,16422,7324,2966,3290,1156,182,2783,.7469136,.6116378,.2149098,.0338353,.4675473,.2196034,.0991206,21.37223
47127,262199,21417,40383,141048,181431,112809,60817,31552,144262,70899,34194,31453,10082,2642,13845,.6464491,.7788674,.2496595,.0654236,.7997916,.4311795,.2236969,16.73721
47128,15329,1127,1810,9595,11405,5601,2851,1603,6780,3210,1702,1179,359,99,793,.703638,.6513812,.1983425,.0546961,.5837415,.2971339,.1670662,22.52775
47129,9870,2000,4975,3942,8917,3055,2324,1590,7906,5920,2089,4851,3596,499,1927,.9635,.9750754,.7228141,.1003015,.7749873,.5895485,.4033486,26.05994
47130,20217,1483,2886,12690,15576,6990,3452,1778,9156,4334,1932,2166,882,154,950,.6405934,.7505198,.3056133,.0533611,.5508274,.2720252,.1401103,38.38771
47192,5046,303,513,3318,3831,1749,772,341,2127,929,383,378,157,42,246,.8118812,.7368421,.3060429,.0818713,.5271248,.2326703,.1027728,
48001,13267,969,1434,7242,8676,4755,2065,969,5619,2323,1021,864,258,52,636,.6563467,.6025105,.1799163,.0362622,.6565866,.2851422,.1338028,15.22545
48002,16823,1152,1854,10028,11882,7366,2991,1183,8639,3325,1205,1273,334,22,849,.7369792,.6866235,.180151,.0118662,.7345433,.2982649,.1179697,19.34841
48003,109444,7525,13342,61649,74991,50138,27156,13937,60337,30701,14750,10199,3545,813,5361,.7124252,.7644281,.2657023,.0609354,.8132817,.4404938,.2260702,10.60321
48004,45061,2967,5020,28435,33455,19655,9646,4133,23273,10945,4386,3618,1299,253,2047,.6899225,.7207171,.258765,.0503984,.6912256,.3392298,.145349,14.43586
48005,51648,3430,5982,31707,37689,23256,10615,4384,27631,11862,4627,4375,1247,243,2438,.7107872,.7313607,.2084587,.0406219,.7334658,.3347841,.138266,16.76352
48006,192227,13611,22131,109734,131865,83151,39265,15588,99185,43863,16206,16034,4598,618,8914,.6549115,.7245041,.2077629,.0279246,.7577506,.3578198,.1420526,12.77381
48007,4057,264,275,2698,2973,1941,712,195,2114,769,206,173,57,11,216,.8181818,.6290909,.2072727,.04,.7194218,.2638992,.0722758,22.67569
48008,79548,5661,9092,46363,55455,32969,14023,5092,39710,15760,5440,6741,1737,348,3873,.6841547,.741421,.1910471,.0382754,.7111058,.302461,.109829,15.0722
48009,22144,1564,2398,13135,15533,9417,4285,1655,11019,4773,1721,1602,488,66,1061,.6783888,.6680567,.2035029,.0275229,.7169394,.3262276,.1259992,12.26596
48010,5811,479,638,3160,3798,2274,986,481,2678,1086,518,404,100,37,375,.782881,.6332288,.1567398,.0579937,.7196202,.3120253,.1522152,21.47704
48011,35025,2547,4600,18712,23312,13433,6304,2341,16562,7261,2532,3129,957,191,1664,.6533176,.6802174,.2080435,.0415217,.7178816,.3368961,.1251069,17.1209
48012,2468,151,192,1602,1794,1223,594,203,1356,656,220,133,62,17,127,.8410596,.6927083,.3229167,.0885417,.7634207,.3707865,.1267166,9.700974
48013,48522,3778,5541,27147,32688,18478,8001,3111,21918,9204,3270,3440,1203,159,2536,.6712546,.6208265,.2171088,.0286952,.6806645,.2947287,.1145983,16.3869
48014,66314,4623,7588,39715,47303,26740,10358,3901,31941,11793,4079,5201,1435,178,3224,.6973826,.6854243,.1891144,.0234581,.6732972,.2608083,.0982248,16.2777
48015,44048,3055,6202,25493,31695,20967,10386,4497,25956,11446,4661,4989,1060,164,1892,.6193126,.8044179,.1709126,.0264431,.8224611,.4074059,.1764014,19.36158
48016,15965,909,1370,10635,12005,8182,4042,1875,9153,4326,1919,971,284,44,617,.6787679,.7087591,.2072993,.0321168,.7693465,.3800658,.1763047,18.59513
48017,1269749,87391,172744,785967,958711,649431,384914,205783,791569,452877,221272,142138,67963,15489,63282,.7241249,.8228245,.3934319,.0896645,.8262828,.489733,.2618214,10.35979
48018,147152,10242,19423,85446,104869,68071,33819,13999,83041,37731,14571,14970,3912,572,6693,.6534857,.7707357,.2014107,.0294496,.7966552,.3957938,.1638345,13.15075
48019,24877,2532,5592,13595,19187,10117,5515,2809,15166,8633,3083,5049,3118,274,2109,.8329384,.902897,.5575823,.0489986,.7441707,.4056638,.2066201,19.44416
48020,15822,1014,1620,9356,10976,6319,2341,897,7305,2584,947,986,243,50,632,.6232741,.608642,.15,.0308642,.6753955,.2502138,.0958743,15.8359
48021,56025,4167,5915,33248,39163,22414,9098,3490,26533,10206,3610,4119,1108,120,2875,.6899448,.6963652,.1873204,.0202874,.6741458,.2736405,.1049687,20.95056
48022,9604,585,722,6205,6927,4764,2304,927,5301,2477,970,537,173,43,493,.8427351,.7437673,.2396122,.0595568,.7677679,.3713135,.1493956,13.00202
48023,31184,2126,3678,19156,22834,13630,5787,2216,15975,6377,2353,2345,590,137,1280,.6020696,.6375748,.1604133,.0372485,.7115264,.3020986,.1156818,14.20858
48024,30639,1997,2923,18392,21315,12851,5629,2339,14913,6174,2413,2062,545,74,1329,.6654983,.7054396,.1864523,.0253165,.6987277,.306057,.1271749,21.17145
48025,17237,1065,1566,11221,12787,7573,2703,1063,8685,2953,1092,1112,250,29,776,.7286385,.7100894,.1596424,.0185185,.6748953,.2408876,.0947331,24.69871
48026,8580,636,737,5105,5842,3479,1386,535,3923,1532,557,444,146,22,436,.6855346,.6024423,.1981004,.0298507,.6814888,.2714985,.1047992,21.29507
48027,485643,38974,76532,271913,348445,207581,95145,41114,266149,113145,43999,58568,18000,2885,25076,.6434033,.7652746,.2351957,.0376966,.7634096,.3499097,.1512028,16.56083
48028,7838,336,494,5593,6087,4923,3215,1749,5340,3355,1767,417,140,18,242,.7202381,.8441296,.2834008,.0364372,.8802074,.5748257,.3127123,25.26278
48029,64138,4327,6879,39576,46455,29475,13376,5225,34458,15077,5394,4983,1701,169,3028,.699792,.7243785,.2472743,.0245675,.7447696,.3379826,.1320245,16.41869
48030,7919,551,863,4619,5482,3324,1284,568,3902,1407,599,578,123,31,320,.5807623,.6697567,.1425261,.0359212,.7196363,.2779822,.1229703,14.14707
48031,337720,23824,41142,196410,237552,153147,74862,30024,184383,85220,31676,31236,10358,1652,15876,.6663868,.7592242,.2517622,.0401536,.7797312,.3811517,.1528639,13.39963
48032,341835,25776,47387,198508,245895,155322,80350,35442,193849,97734,37972,38527,17384,2530,19142,.7426288,.8130289,.3668517,.0533902,.782447,.4047696,.1785419,14.80772
48033,28979,1985,2811,16363,19174,12204,5047,1722,14250,5562,1777,2046,515,55,1378,.6942065,.7278548,.1832088,.019566,.745829,.3084398,.1052374,26.21588
48034,124264,8688,14724,72643,87367,58087,30635,14781,69245,34995,15432,11158,4360,651,6226,.7166206,.7578104,.2961152,.0442135,.7996228,.4217199,.2034745,15.13017
48035,3832,270,310,2313,2623,1475,521,198,1698,575,206,223,54,8,214,.7925926,.7193549,.1741935,.0258065,.6377,.2252486,.0856031,22.56098
48036,47435,4043,7344,28188,35532,21202,11511,5143,27113,14723,5411,5911,3212,268,3253,.8046005,.8048747,.4373638,.0364924,.7521641,.4083652,.1824535,15.81597
48037,106701,8419,17462,60973,78435,46673,23040,10929,61360,30577,11754,14687,7537,825,6260,.7435563,.8410835,.431623,.0472454,.76547,.3778722,.1792433,18.08734
48038,40103,5636,14503,17970,32473,15414,10508,6607,29427,20665,8165,14013,10157,1558,5417,.9611427,.9662139,.7003379,.107426,.8577629,.5847524,.3676683,12.73719
48039,172508,13213,20116,99202,119318,61601,27432,11213,73606,30895,11713,12005,3463,500,8692,.657837,.5967886,.1721515,.0248558,.6209653,.2765267,.113032,23.58295
49001,16639,1322,2255,9595,11850,4727,1485,795,6380,2056,900,1653,571,105,932,.7049924,.7330377,.2532151,.0465632,.4926524,.1547681,.0828557,52.34815
49002,46775,3098,5168,27810,32978,15559,5678,2937,19001,6477,3121,3442,799,184,1793,.5787605,.6660216,.1546053,.0356037,.559475,.2041712,.1056095,27.37157
49003,30447,1935,3486,16917,20403,6999,1713,748,9086,2037,788,2087,324,40,1039,.5369509,.5986804,.0929432,.0114745,.4137258,.1012591,.0442159,42.87262
49004,13894,921,1413,8452,9865,3814,1226,686,4836,1418,736,1022,192,50,587,.6373507,.7232838,.1358811,.0353857,.4512541,.1450544,.0811642,54.8876
49005,31117,2442,4243,18375,22618,11526,3409,1768,15067,4799,2025,3541,1390,257,1805,.7391483,.834551,.3275984,.0605704,.6272653,.1855238,.0962177,15.27611
49006,106835,7596,14584,64908,79492,39981,17894,9051,51548,23491,9947,11567,5597,896,5580,.7345971,.7931294,.3837768,.0614372,.6159641,.2756825,.1394435,24.15261
49007,8250,585,908,4945,5853,2120,595,261,2696,731,289,576,136,28,331,.565812,.6343612,.1497797,.030837,.4287159,.1203236,.0527806,52.82972
49008,11265,778,1140,6160,7300,2258,522,320,2840,601,349,582,79,29,426,.5475578,.5105263,.0692982,.0254386,.3665584,.0847403,.0519481,63.61501
49009,7433,545,773,4356,5129,2257,748,417,2759,855,431,502,107,14,321,.5889908,.6494179,.1384217,.0181113,.5181359,.1717172,.09573,46.59602
49010,57863,4385,7335,33403,40738,15612,5289,2471,20559,6929,2729,4947,1640,258,2934,.6690992,.6744376,.2235855,.0351738,.4673832,.1583391,.0739754,43.15839
49011,8334,833,1507,4572,6079,2124,930,519,3363,1549,582,1239,619,63,661,.7935174,.8221632,.4107498,.0418049,.4645669,.2034121,.1135171,55.71355
49012,10210,705,1082,6054,7136,2722,887,466,3421,991,506,699,104,40,389,.5517731,.6460259,.0961183,.0369686,.4496201,.1465147,.0769739,57.36861
49013,37665,2645,4230,22858,27088,12184,4491,2410,14777,5166,2615,2593,675,205,1535,.5803403,.6130024,.1595745,.0484634,.53303,.1964739,.1054335,45.24145
49014,14867,1153,1502,8749,10251,4649,1491,895,5711,1719,980,1062,228,85,806,.699046,.7070572,.1517976,.0565912,.531375,.1704195,.1022974,50.84746
49015,40418,2924,4789,24350,29139,15112,4481,1860,18941,5493,2066,3829,1012,206,1999,.6836525,.7995406,.2113176,.0430152,.620616,.1840246,.076386,9.933592
49016,10030,731,1125,6130,7255,2685,791,341,3456,909,371,771,118,30,469,.6415868,.6853333,.1048889,.0266667,.4380098,.1290375,.0556281,51.98434
49017,77710,5275,8709,47755,56464,29005,10244,5185,35493,12343,5577,6488,2099,392,3625,.6872038,.7449765,.241015,.0450109,.607371,.2145116,.108575,26.69057
49018,25794,1955,2985,14967,17952,8659,2869,1304,10826,3409,1404,2167,540,100,1216,.6219949,.7259632,.1809045,.0335008,.5785394,.1916884,.087125,34.4421
49019,30302,2478,4225,17217,21442,9769,4558,2801,12990,5893,2995,3221,1335,194,1720,.6941081,.7623669,.3159763,.0459172,.5674043,.2647384,.162688,36.69223
49020,231414,15255,27176,143432,170608,93237,40501,21942,113660,47484,23865,20423,6983,1923,9887,.6481154,.7515087,.2569547,.070761,.6500432,.2823707,.1529784,23.54992
49021,18813,1225,1982,11712,13694,5948,1845,884,7292,2128,947,1344,283,63,720,.5877551,.6781029,.1427851,.0317861,.5078552,.1575307,.0754781,41.77532
49022,23675,1823,2683,13039,15722,5327,1356,632,6925,1565,662,1598,209,30,1028,.5639057,.5956019,.0778979,.0111815,.4085436,.1039957,.04847,56.3735
49023,50679,3464,6125,27848,33973,12558,3587,1549,16341,4381,1656,3783,794,107,1797,.5187644,.6176326,.1296327,.0174694,.450948,.1288064,.0556234,38.78633
49024,49899,3703,5906,26665,32571,9576,2560,1381,12315,3152,1576,2739,592,195,2058,.5557656,.4637657,.100237,.0330173,.3591225,.096006,.0517907,50.34857
49025,65789,4522,8102,40196,48298,24844,9126,4459,31375,11836,4907,6531,2710,448,3303,.730429,.8060973,.3344853,.055295,.6180714,.2270375,.1109314,24.23911
49026,41608,2647,4548,25034,29582,15199,4204,1857,18573,5043,2048,3374,839,191,1842,.6958821,.7418646,.1844767,.0419965,.6071343,.1679316,.0741791,20.4835
49027,27045,2068,3237,15866,19103,8361,2238,1103,10608,2702,1195,2247,464,92,1205,.5826886,.6941612,.1433426,.0284214,.5269759,.1410563,.0695197,33.12574
49028,73942,5204,9081,43933,53014,23371,9320,4449,29970,11835,4893,6599,2515,444,3297,.6335511,.7266821,.2769519,.0488933,.5319691,.2121412,.1012678,39.68028
49029,27234,2065,3077,16034,19111,9613,2826,1136,12111,3480,1211,2498,654,75,1529,.7404358,.8118297,.2125447,.0243744,.5995385,.1762505,.0708494,30.67045
49030,37336,2656,4623,19501,24124,7676,2438,1246,10256,2893,1316,2580,455,70,1431,.5387801,.5580792,.0984209,.0151417,.3936208,.1250192,.0638942,51.92487
49031,75024,7528,19420,38999,58419,25805,13736,9329,43340,25458,11795,17535,11722,2466,6357,.8444474,.9029351,.6036046,.1269825,.6616836,.3522142,.2392113,29.73084
49032,12873,942,1286,7820,9106,4097,1376,614,5007,1582,659,910,206,45,646,.6857749,.7076205,.1601866,.0349922,.523913,.1759591,.0785166,50.82694
49033,10711,656,1098,6542,7640,3532,1182,628,4314,1363,676,782,181,48,390,.5945122,.712204,.1648452,.0437158,.5398961,.1806787,.0959951,41.9189
49034,28126,2007,3092,15882,18974,7600,1965,947,9710,2448,1102,2110,483,155,1187,.59143,.6824062,.1562096,.0501294,.4785292,.123725,.0596272,47.41753
49035,61389,4545,8802,38010,46812,24844,9612,5031,32163,12829,5541,7319,3217,510,3412,.7507151,.8315156,.3654851,.0579414,.6536174,.2528808,.1323599,19.50924
49036,7910,473,901,4853,5754,2288,751,388,2948,873,417,660,122,29,280,.5919662,.7325194,.1354051,.0321865,.4714609,.1547496,.0799505,53.96785
49037,8236,633,1073,4656,5729,2680,776,360,3330,923,401,650,147,41,363,.5734597,.6057782,.1369991,.0382106,.5756014,.1666667,.0773196,32.75936
49038,9919,608,1025,6124,7149,2863,1010,582,3535,1117,609,672,107,27,326,.5361842,.6556097,.1043902,.0263415,.4675049,.1649249,.0950359,47.03561
49039,30460,1983,3429,17606,21035,8881,2489,1210,11236,2877,1286,2355,388,76,1213,.6116995,.6867892,.1131525,.0221639,.5044303,.1413723,.0687266,49.52631
49040,38181,2641,4094,22459,26553,14053,4727,2382,17072,5387,2545,3019,660,163,1794,.6792881,.7374206,.1612115,.0398144,.625718,.2104724,.1060599,29.81691
49041,86821,5490,9487,51219,60706,27474,10495,4667,33866,12052,5027,6392,1557,360,3621,.6595628,.6737641,.1641193,.0379467,.5364025,.2049044,.0911185,44.04916
49042,28734,2282,3882,16753,20635,8840,3105,1707,11744,4140,1909,2904,1035,202,1544,.6765995,.748068,.2666152,.052035,.5276667,.1853399,.1018922,44.57553
49043,11442,698,1230,6952,8182,3514,1011,396,4346,1136,425,832,125,29,418,.5988539,.6764228,.101626,.0235772,.505466,.1454258,.056962,41.8886
49044,15952,1084,1652,9701,11353,4638,1257,650,5715,1460,689,1077,203,39,690,.6365314,.6519371,.1228814,.0236077,.4780951,.1295743,.0670034,46.72791
49045,15875,1020,1832,9785,11617,4711,1521,622,5758,1692,661,1047,171,39,486,.4764706,.5715066,.0933406,.0212882,.4814512,.155442,.0635667,58.06343
49046,16584,1149,1682,9959,11641,5589,1627,748,6741,1863,821,1152,236,73,757,.6588337,.6848989,.1403092,.0434007,.5612009,.1633698,.0751079,42.96217
49047,8675,643,877,5273,6150,2823,822,410,3397,911,421,574,89,11,452,.7029549,.654504,.1014823,.0125428,.5353689,.1558885,.0777546,49.69712
49048,11320,834,1137,6638,7775,3827,1088,481,4670,1267,524,843,179,43,590,.7074341,.7414248,.1574318,.0378188,.5765291,.1639048,.0724616,40.09452
49049,23427,2037,3904,12937,16841,7381,2649,1501,10574,4076,1645,3193,1427,144,1473,.7231222,.8178791,.3655225,.0368852,.5705341,.2047615,.1160238,46.3832
49050,46021,3329,5306,26556,31862,13432,4098,1843,16941,5163,2026,3509,1065,183,2127,.6389306,.6613268,.2007162,.0344893,.5057991,.1543154,.0694005,41.16393
49051,12245,831,1304,6941,8245,2428,753,389,3136,886,435,708,133,46,407,.4897714,.5429448,.1019939,.0352761,.3498055,.1084858,.0560438,63.75
49052,21874,1623,2307,12799,15106,7572,2236,1179,9149,2548,1306,1577,312,127,1129,.6956254,.6835718,.1352406,.0550498,.5916087,.1747012,.0921166,27.56387
49053,4922,431,550,2848,3398,1471,429,197,1897,530,225,426,101,28,312,.7238979,.7745454,.1836364,.0509091,.5165028,.150632,.0691713,45.64711
49054,93648,6594,10744,55917,66661,36377,13808,6389,44507,16273,6788,8130,2465,399,4554,.6906279,.7567014,.2294304,.037137,.6505535,.2469374,.1142586,20
49055,35993,2555,4556,18980,23536,7996,2045,965,10582,2454,1035,2586,409,70,1385,.5420744,.5676032,.0897717,.0153644,.4212856,.107745,.050843,39.37771
50001,13457,937,1325,8739,10064,5011,1675,645,5887,1871,686,876,196,41,691,.73746,.6611321,.1479245,.0309434,.5734066,.1916695,.0738071,36.33458
50002,16783,1375,2076,9932,12008,6529,2572,1209,8250,3134,1282,1721,562,73,1035,.7527273,.8289981,.2707129,.0351638,.6573701,.2589609,.1217277,27.74148
50003,38730,3017,4660,22914,27574,14343,5565,2378,17945,6487,2475,3602,922,97,2100,.6960557,.7729614,.1978541,.0208155,.6259492,.2428646,.1037793,26.81728
50004,13822,901,1259,8557,9816,5829,2401,1161,6843,2650,1212,1014,249,51,624,.6925638,.8054011,.197776,.0405083,.6811967,.280589,.1356784,33.70354
50005,175280,14980,25368,95129,120497,70302,27190,13766,91060,33842,14932,20758,6652,1166,11203,.7478638,.818275,.2622201,.0459634,.7390175,.2858224,.1447088,12.86359
50006,14309,1068,1611,8433,10044,5131,1796,748,6446,2131,789,1315,335,41,750,.7022472,.8162632,.2079454,.02545,.608443,.2129728,.0886992,28.53444
50007,12340,794,1067,7848,8915,4784,1502,614,5590,1664,625,806,162,11,515,.6486146,.7553889,.1518276,.0103093,.6095821,.1913863,.0782365,36.96456
50008,30867,2710,3866,16511,20377,10975,3545,1745,14083,4098,1831,3108,553,86,1903,.702214,.8039317,.1430419,.0222452,.6647084,.2147053,.1056871,14.18723
50009,52127,4216,5992,29364,35356,18652,5945,2729,23112,7050,2888,4460,1105,159,2950,.6997154,.7443258,.1844126,.0265354,.6351995,.2024588,.0929369,23.51452
50010,32910,2490,3336,18922,22258,10636,3271,1398,13161,3794,1527,2525,523,129,1765,.7088354,.7568945,.1567746,.0386691,.562097,.1728676,.0738823,30.06562
50011,43222,3098,4494,26136,30630,18089,6742,2911,21575,7781,3117,3486,1039,206,2258,.7288573,.7757009,.2311971,.0458389,.6921105,.2579584,.1113789,21.39452
50012,16556,1277,1690,9662,11352,6015,2116,963,7330,2407,1047,1315,291,84,889,.6961629,.7781065,.1721894,.0497041,.6225419,.2190023,.0996688,33.13854
50013,323545,27645,61676,181024,242700,151593,90334,55877,206346,123888,63362,54753,33554,7485,22007,.7960572,.8877521,.5440366,.12136,.8374193,.4990167,.3086718,12.61715
50014,75064,5311,8674,44272,52946,27348,8804,4085,33891,10224,4387,6543,1420,302,3504,.6597627,.7543232,.1637076,.0348167,.6177268,.1988616,.0922705,17.19859
50015,25029,1715,3042,15138,18180,10271,4089,1979,12778,4573,2066,2507,484,87,1072,.6250729,.8241289,.1591059,.0285996,.6784912,.2701149,.1307306,21.89171
50016,44421,3430,6024,26133,32157,18097,6850,3085,22901,8477,3350,4804,1627,265,2431,.7087464,.7974768,.2700863,.0439907,.6924961,.2621207,.11805,20.2761
50017,34314,3727,8178,17355,25533,11731,5458,2824,19276,9970,3269,7545,4512,445,3266,.876308,.9225972,.5517241,.0544143,.6759436,.3144915,.1627197,29.62545
50018,78805,8339,16214,42038,58252,31512,14087,7534,46223,21813,8336,14711,7726,802,6885,.8256386,.9073023,.4765018,.0494634,.7496075,.3351016,.1792188,15.47518
50019,4172,311,399,2534,2933,1580,491,211,1892,553,227,312,62,16,187,.6012862,.7819549,.1553885,.0401003,.6235201,.1937648,.0832676,32.26683
50020,88964,7141,11586,50729,62315,34566,12057,5752,43924,14994,6205,9358,2937,453,5311,.7437333,.807699,.2534956,.0390989,.6813854,.2376747,.1133868,15.80423
50021,9044,840,1058,5217,6275,2977,972,415,3619,1089,438,642,117,23,565,.672619,.6068053,.110586,.0217391,.5706345,.186314,.0795476,32.63786
50022,51736,5071,8919,27386,36305,18499,7265,3791,26356,10890,4186,7857,3625,395,4139,.8162098,.8809283,.4064357,.0442875,.6754912,.2652815,.1384284,29.69504
50023,30012,2197,3317,17748,21065,11878,4272,1936,14422,4836,2026,2544,564,90,1465,.6668184,.7669581,.1700332,.027133,.6692585,.2407032,.1090827,19.92227
50024,18370,1257,1810,11394,13204,7125,2469,1184,8489,2815,1253,1364,346,69,914,.7271281,.7535912,.1911602,.0381215,.6253291,.216693,.1039143,18.93612
50025,19802,1600,2308,11279,13587,7947,2863,1286,9773,3325,1366,1826,462,80,1160,.725,.7911612,.2001733,.034662,.7045838,.2538345,.1140172,32.76756
50026,6730,432,663,4426,5089,2772,1049,374,3302,1220,398,530,171,24,293,.6782407,.7993967,.2579186,.0361991,.6262991,.2370086,.0845007,24.81898
50027,16831,1217,1721,10147,11868,6211,1922,807,7507,2218,877,1296,296,70,811,.6663927,.7530506,.171993,.040674,.6121021,.1894156,.0795309,33.47414
50028,66152,6022,9548,37634,47182,25461,9686,4725,33020,12384,5067,7559,2698,342,4671,.7756559,.7916842,.2825723,.035819,.6765425,.2573737,.1255514,14.61332
50029,21039,1587,2096,12644,14740,7472,2370,979,9035,2711,1082,1563,341,103,1126,.7095148,.7457061,.1626908,.0491412,.5909522,.1874407,.077428,27.73905
50030,123137,10126,16455,70635,87090,45772,17102,7578,58370,21360,8151,12598,4258,573,6902,.6816117,.7656032,.2587663,.0348222,.6480073,.2421179,.1072839,8.426527
50031,19539,1547,2347,11019,13366,6940,2009,847,8810,2333,901,1870,324,54,1088,.7032967,.7967618,.1380486,.0230081,.6298212,.1823214,.0768672,21.44614
50032,91056,8803,17700,49858,67558,36666,17084,8649,52713,25445,9867,16047,8361,1218,7119,.8087016,.9066102,.4723729,.0688136,.7354085,.3426531,.1734727,15.95706
50033,17412,1475,2065,9805,11870,6547,2017,909,8211,2507,1011,1664,490,102,1128,.7647458,.8058112,.2372881,.0493947,.6677206,.2057114,.0927078,27.7553
50034,19978,1553,2092,11843,13935,6993,2414,1011,8458,2731,1048,1465,317,37,1149,.7398583,.7002868,.1515296,.0176864,.5904754,.2038335,.0853669,30.53323
50035,26555,2183,2856,15667,18523,9343,3376,1541,11397,3899,1646,2054,523,105,1570,.7191938,.7191877,.1831232,.0367647,.596349,.2154848,.0983596,22.39453
50036,82918,6500,9995,48256,58251,32281,9881,4801,40115,11670,5205,7834,1789,404,4584,.7052308,.7837919,.1789895,.0404202,.6689531,.2047621,.0994902,12.834
50037,111270,8871,14234,62513,76747,40390,15298,7267,52248,18727,7933,11858,3429,666,6333,.7138992,.8330758,.2409021,.0467894,.6461056,.2447171,.1162478,18.4826
50038,39314,2843,4245,23590,27835,15302,4899,2034,18563,5558,2152,3261,659,118,1977,.6953922,.7681979,.1552415,.0277974,.6486647,.2076727,.086223,24.38855
50039,11672,820,1105,7412,8517,4343,1444,594,5146,1621,631,803,177,37,520,.6341463,.7266968,.160181,.0334842,.5859417,.1948192,.0801403,26.89276
50040,3373,352,439,1446,1885,585,174,23,840,185,23,255,11,0,139,.3948864,.5808656,.0250569,0,.4045643,.120332,.0159059,9.819432
50041,964988,70693,136260,573276,709536,392692,178458,89876,499122,222680,100549,106430,44222,10673,48170,.681397,.7810803,.3245413,.0783282,.6849964,.3112951,.1567761,24.19574
50042,35074,2534,3619,20733,24352,13275,4407,1852,16068,5049,1959,2793,642,107,1793,.7075769,.7717602,.1773971,.0295662,.6402836,.2125597,.0893262,28.89503
50043,28947,2283,3022,17016,20038,10023,2880,1259,12299,3293,1350,2276,413,91,1530,.6701708,.7531436,.1366645,.0301125,.5890338,.1692525,.0739892,21.39711
50044,31216,2264,3292,19379,22671,13663,5766,2566,16026,6345,2667,2363,579,101,1622,.7164311,.7178007,.1758809,.0306804,.7050415,.2975386,.1324114,12.16092
50045,128799,11345,17670,69962,87632,50587,18501,9322,65026,22290,10031,14439,3789,709,8163,.719524,.8171477,.2144312,.0401245,.7230639,.2644435,.1332438,7.80101
50046,66981,5419,7506,38558,46064,30631,15937,9164,36647,18093,9680,6016,2156,516,4147,.7652704,.8014922,.2872369,.068745,.7944136,.4133254,.2376679,28.97404
50047,7477,612,860,4283,5143,2520,822,369,3203,970,398,683,148,29,415,.6781046,.7941861,.172093,.0337209,.5883726,.1919215,.0861546,22.82106
50048,31149,3370,6120,15911,22031,11133,4820,2580,16616,7624,2898,5483,2804,318,2822,.8373887,.895915,.4581699,.0519608,.6997046,.3029351,.162152,24.86829
50049,32351,2392,3372,19314,22686,13014,4945,2056,15621,5511,2137,2607,566,81,1610,.6730769,.7731317,.1678529,.0240214,.6738117,.2560319,.1064513,22.30639
50050,57420,6130,12005,29136,41141,20002,8987,5097,30637,14387,5775,10635,5400,678,4936,.8052202,.8858809,.4498126,.0564765,.6865047,.30845,.1749382,33.44212
50051,15788,1043,1404,9642,11046,5869,1930,799,7000,2220,886,1131,290,87,746,.7152445,.8055556,.2065527,.0619658,.6086912,.2001659,.0828666,9.947258
50052,173132,13637,21496,98079,119575,66381,27226,13694,82264,32027,14603,15883,4801,909,9098,.6671555,.7388816,.2233439,.0422869,.6768116,.2775925,.1396221,32.56067
50053,17476,1307,1981,10476,12457,6635,2573,1087,8195,2976,1147,1560,403,60,845,.6465188,.7874811,.2034326,.0302877,.6333524,.245609,.103761,12.69858
50054,139420,11098,17977,78829,96806,56021,20035,9759,69535,23798,10481,13514,3763,722,7661,.6903046,.7517383,.209323,.0401624,.7106649,.2541577,.1237996,30.63087
50055,15589,1247,1751,9052,10803,5483,1842,847,6852,2188,919,1369,346,72,901,.7225341,.781839,.1976014,.0411194,.6057225,.2034909,.0935705,20.55548
50056,43262,3494,5392,23847,29239,17582,7141,3598,21861,8380,3833,4279,1239,235,2467,.7060676,.7935831,.2297849,.0435831,.7372835,.2994507,.1508785,25.28483
50057,43469,3055,4660,26032,30692,17124,6684,2920,20686,7595,3113,3562,911,193,2162,.7076923,.7643777,.1954936,.0414163,.6578058,.2567609,.1121696,35.35258
50058,12843,878,1132,8030,9162,5206,2005,942,6065,2243,986,859,238,44,516,.5876993,.7588339,.2102474,.0388693,.6483188,.2496887,.1173101,34.41085
50059,35928,2738,3607,21422,25029,12260,3782,1649,15051,4271,1750,2791,489,101,1917,.7001461,.7737732,.1355697,.0280011,.5723088,.1765475,.0769769,11.67232
50060,100935,7498,12331,59215,71546,40119,13815,6646,49745,16472,7275,9626,2657,629,5451,.7269939,.7806342,.2154732,.0510097,.6775141,.2333024,.1122351,35.68075
50061,18817,1504,2305,10408,12713,5708,1862,826,7451,2210,906,1743,348,80,1022,.6795213,.7561822,.1509761,.0347072,.5484243,.1789009,.079362,27.83715
50062,26158,1817,2569,15669,18238,9388,3132,1483,11379,3623,1584,1991,491,101,1341,.7380297,.7750098,.1911249,.0393149,.5991448,.1998851,.0946455,32.54535
50063,25642,1783,2472,15951,18423,9412,3761,1597,11258,4279,1681,1846,518,84,1272,.7134044,.7467638,.2095469,.0339806,.5900571,.2357846,.1001191,29.69843
50064,16535,1079,1356,11008,12364,7693,3197,1285,8694,3453,1325,1001,256,40,733,.6793327,.7382006,.1887906,.0294985,.6988554,.2904252,.1167333,16.36624
50065,71507,6254,11391,40711,52102,28911,12368,6243,38248,17085,6723,9337,4717,480,4650,.7435241,.8196822,.4140989,.0421385,.710152,.3038,.1533492,28.81175
50066,13174,905,1211,8191,9402,5283,1872,849,6177,2068,902,894,196,53,626,.6917127,.7382329,.1618497,.0437655,.6449762,.2285435,.1036503,11.37862
50067,84848,6733,9729,46623,56352,33610,12919,6440,41321,14807,6772,7711,1888,332,4603,.6836477,.7925789,.194059,.0341248,.7208889,.277095,.1381292,7.90134
50068,280326,23567,30869,159217,190086,129117,63890,34262,154119,73611,36095,25002,9721,1833,18047,.7657742,.8099388,.3149114,.05938,.8109499,.4012762,.2151906,22.57205
50069,42831,2972,4481,26030,30511,16211,5333,2409,19707,5991,2539,3496,658,130,1996,.6716016,.780183,.1468422,.0290114,.6227814,.204879,.0925471,32.60632
50070,18526,1224,1729,11687,13416,6893,2354,1022,8109,2574,1044,1216,220,22,827,.6756536,.7032967,.1272412,.0127241,.5898007,.2014204,.0874476,11.39709
50071,131703,11386,20621,75417,96038,54316,21713,11547,71466,28806,12589,17150,7093,1042,8773,.7705076,.8316764,.3439697,.050531,.7202089,.2879059,.1531087,15.42452
50072,72799,5838,9242,40995,50237,27835,9586,4666,35301,11596,5016,7466,2010,350,4366,.7478589,.8078338,.2174854,.0378706,.6789852,.2338334,.1138188,
51001,29062,3115,8489,13929,22418,11794,8077,4949,19806,13349,5645,8012,5272,696,2643,.8484751,.9438096,.621039,.0819885,.8467227,.5798693,.3553019,18.09366
51002,11896,860,1191,6803,7994,4814,2172,837,5732,2411,881,918,239,44,599,.6965116,.7707809,.2006717,.0369437,.707629,.3192709,.123034,23.13265
51003,24367,1775,4293,11715,16008,9388,4152,1583,12654,5106,1769,3266,954,186,803,.4523944,.7607734,.2222222,.0433263,.8013658,.3544174,.1351259,11.77966
51004,21896,1561,3099,11671,14770,8794,3708,1615,11057,4291,1741,2263,583,126,778,.4983985,.7302356,.1881252,.0406583,.7534916,.3177106,.1383772,15.45315
51005,14069,988,1958,7094,9052,5395,2304,948,6860,2605,1015,1465,301,67,544,.5506073,.7482125,.1537283,.0342186,.7605019,.3247815,.1336341,17.92049
51006,5308,384,582,2942,3524,2123,909,378,2570,1039,400,447,130,22,259,.6744792,.7680413,.2233677,.0378007,.7216179,.3089735,.128484,21.4805
51007,38992,2918,5182,20816,25998,15194,6950,3393,18946,8075,3604,3752,1125,211,1650,.5654558,.7240448,.2170976,.0407179,.7299193,.3338778,.1629996,22.85802
51008,12040,1012,1417,7151,8568,4996,2413,962,6091,2843,1011,1095,430,49,790,.7806324,.7727594,.303458,.0345801,.6986436,.3374353,.1345266,22.73797
51009,5710,345,604,3477,4081,2443,1134,297,2878,1237,311,435,103,14,222,.6434783,.7201987,.1705298,.0231788,.7026172,.3261432,.0854185,16.15721
51010,6700,450,678,4044,4722,3069,1467,602,3566,1597,626,497,130,24,317,.7044445,.7330384,.1917404,.0353982,.7589021,.3627596,.1488625,18.8885
51011,68649,5331,9747,38447,48194,30814,15103,6815,38469,17345,7335,7655,2242,520,3523,.6608516,.7853699,.2300195,.0533497,.8014669,.3928265,.177257,11.25626
51012,12177,872,1264,6222,7486,4653,1939,779,5624,2181,813,971,242,34,612,.7018349,.7681962,.1914557,.0268987,.7478303,.3116361,.1252009,23.89997
51013,71856,5222,10653,39579,50232,32656,17323,7791,41010,20397,8419,8354,3074,628,3232,.61892,.7841923,.2885572,.0589505,.825084,.4376816,.1968468,10.69133
51014,2924,159,319,1843,2162,1300,528,213,1551,580,224,251,52,11,105,.6603774,.7868339,.1630094,.0344828,.7053717,.2864894,.1155724,19.66475
51015,21639,1738,2746,12407,15153,9664,4382,2031,11834,5300,2154,2170,918,123,1411,.8118527,.7902403,.3343045,.0447924,.7789151,.3531877,.1636979,16.11489
51016,11975,733,1414,6883,8297,5059,1960,806,6168,2265,861,1109,305,55,438,.5975443,.7842999,.2157001,.0388967,.7349993,.2847596,.1171001,21.58294
51017,25048,1644,2834,14943,17777,11396,5677,2542,13602,6460,2648,2206,783,106,1111,.6757907,.7784051,.2762879,.037403,.7626314,.3799103,.1701131,17.13211
51018,4548,323,458,2593,3051,2029,1016,475,2386,1132,488,357,116,13,229,.7089784,.779476,.2532751,.0283843,.7824913,.3918242,.1831855,14.09236
51019,41723,2762,6269,21228,27497,16207,6973,2963,20976,8269,3218,4769,1296,255,1379,.4992759,.7607274,.2067315,.0406763,.7634728,.3284813,.1395798,11.30223
51020,9355,535,1436,5696,7132,5151,3599,1888,6388,4221,2114,1237,622,226,301,.5626168,.8614206,.4331476,.1573816,.9043188,.6318469,.3314607,14.10013
51021,13021,954,1871,6459,8330,5028,2002,762,6448,2406,823,1420,404,61,481,.5041929,.7589524,.2159273,.0326029,.7784487,.3099551,.1179749,14.84044
51022,9496,750,1010,5263,6273,3962,1686,662,4676,1913,725,714,227,63,519,.692,.7069307,.2247525,.0623762,.7528026,.3203496,.1257838,17.28771
51023,7106,472,913,3944,4857,2867,1280,476,3522,1447,508,655,167,32,262,.5550848,.7174151,.1829135,.0350493,.726927,.3245436,.1206897,11.69195
